Model,Case,File,Input Tokens,Output Tokens,Total Tokens
gemini-1.0-pro-002,RDD vs DataFrame,case0-1.py,1412,817,2229
gemini-1.0-pro-002,Coalesce vs Repartition,case0-1.py,1390,353,1743
gemini-1.0-pro-002,Map vs MapPartitions,case0-1.py,1379,446,1825
gemini-1.0-pro-002,Serialized Data Formats,case0-1.py,1423,468,1891
gemini-1.0-pro-002,Avoiding UDFs,case0-1.py,1389,317,1706
gemini-1.0-pro-002,All,case0-1.py,2232,617,2849
gemini-1.5-flash-002,RDD vs DataFrame,case0-1.py,1412,1157,2569
gemini-1.5-flash-002,Coalesce vs Repartition,case0-1.py,1390,31,1421
gemini-1.5-flash-002,Map vs MapPartitions,case0-1.py,1379,750,2129
gemini-1.5-flash-002,Serialized Data Formats,case0-1.py,1423,714,2137
gemini-1.5-flash-002,Avoiding UDFs,case0-1.py,1389,762,2151
gemini-1.5-flash-002,All,case0-1.py,2232,1994,4226
gemini-2.0-flash-exp,RDD vs DataFrame,case0-1.py,1412,1789,3201
gemini-2.0-flash-exp,Coalesce vs Repartition,case0-1.py,1390,31,1421
gemini-2.0-flash-exp,Map vs MapPartitions,case0-1.py,1379,829,2208
gemini-2.0-flash-exp,Serialized Data Formats,case0-1.py,1423,1023,2446
gemini-2.0-flash-exp,Avoiding UDFs,case0-1.py,1389,741,2130
gemini-2.0-flash-exp,All,case0-1.py,2232,3066,5298
gemini-1.0-pro-002,RDD vs DataFrame,case0-10.py,868,999,1867
gemini-1.0-pro-002,Coalesce vs Repartition,case0-10.py,846,227,1073
gemini-1.0-pro-002,Map vs MapPartitions,case0-10.py,835,338,1173
gemini-1.0-pro-002,Serialized Data Formats,case0-10.py,879,212,1091
gemini-1.0-pro-002,Avoiding UDFs,case0-10.py,845,30,875
gemini-1.0-pro-002,All,case0-10.py,1688,447,2135
gemini-1.5-flash-002,RDD vs DataFrame,case0-10.py,868,750,1618
gemini-1.5-flash-002,Coalesce vs Repartition,case0-10.py,846,31,877
gemini-1.5-flash-002,Map vs MapPartitions,case0-10.py,835,387,1222
gemini-1.5-flash-002,Serialized Data Formats,case0-10.py,879,771,1650
gemini-1.5-flash-002,Avoiding UDFs,case0-10.py,845,859,1704
gemini-1.5-flash-002,All,case0-10.py,1688,1117,2805
gemini-2.0-flash-exp,RDD vs DataFrame,case0-10.py,868,989,1857
gemini-2.0-flash-exp,Coalesce vs Repartition,case0-10.py,846,31,877
gemini-2.0-flash-exp,Map vs MapPartitions,case0-10.py,835,554,1389
gemini-2.0-flash-exp,Serialized Data Formats,case0-10.py,879,31,910
gemini-2.0-flash-exp,Avoiding UDFs,case0-10.py,845,912,1757
gemini-2.0-flash-exp,All,case0-10.py,1688,1212,2900
gemini-1.0-pro-002,RDD vs DataFrame,case0-11.py,1315,1081,2396
gemini-1.0-pro-002,Coalesce vs Repartition,case0-11.py,1293,337,1630
gemini-1.0-pro-002,Map vs MapPartitions,case0-11.py,1282,575,1857
gemini-1.0-pro-002,Serialized Data Formats,case0-11.py,1326,327,1653
gemini-1.0-pro-002,Avoiding UDFs,case0-11.py,1292,30,1322
gemini-1.0-pro-002,All,case0-11.py,2135,861,2996
gemini-1.5-flash-002,RDD vs DataFrame,case0-11.py,1315,1709,3024
gemini-1.5-flash-002,Coalesce vs Repartition,case0-11.py,1293,31,1324
gemini-1.5-flash-002,Map vs MapPartitions,case0-11.py,1282,925,2207
gemini-1.5-flash-002,Serialized Data Formats,case0-11.py,1326,416,1742
gemini-1.5-flash-002,Avoiding UDFs,case0-11.py,1292,1014,2306
gemini-1.5-flash-002,All,case0-11.py,2135,2899,5034
gemini-2.0-flash-exp,RDD vs DataFrame,case0-11.py,1315,2033,3348
gemini-2.0-flash-exp,Coalesce vs Repartition,case0-11.py,1293,31,1324
gemini-2.0-flash-exp,Map vs MapPartitions,case0-11.py,1282,1056,2338
gemini-2.0-flash-exp,Serialized Data Formats,case0-11.py,1326,559,1885
gemini-2.0-flash-exp,Avoiding UDFs,case0-11.py,1292,31,1323
gemini-2.0-flash-exp,All,case0-11.py,2135,2263,4398
gemini-1.0-pro-002,RDD vs DataFrame,case0-2.py,917,759,1676
gemini-1.0-pro-002,Coalesce vs Repartition,case0-2.py,895,302,1197
gemini-1.0-pro-002,Map vs MapPartitions,case0-2.py,884,448,1332
gemini-1.0-pro-002,Serialized Data Formats,case0-2.py,928,392,1320
gemini-1.0-pro-002,Avoiding UDFs,case0-2.py,894,30,924
gemini-1.0-pro-002,All,case0-2.py,1737,578,2315
gemini-1.5-flash-002,RDD vs DataFrame,case0-2.py,917,1315,2232
gemini-1.5-flash-002,Coalesce vs Repartition,case0-2.py,895,31,926
gemini-1.5-flash-002,Map vs MapPartitions,case0-2.py,884,578,1462
gemini-1.5-flash-002,Serialized Data Formats,case0-2.py,928,415,1343
gemini-1.5-flash-002,Avoiding UDFs,case0-2.py,894,458,1352
gemini-1.5-flash-002,All,case0-2.py,1737,1971,3708
gemini-2.0-flash-exp,RDD vs DataFrame,case0-2.py,917,2851,3768
gemini-2.0-flash-exp,Coalesce vs Repartition,case0-2.py,895,31,926
gemini-2.0-flash-exp,Map vs MapPartitions,case0-2.py,884,605,1489
gemini-2.0-flash-exp,Serialized Data Formats,case0-2.py,928,553,1481
gemini-2.0-flash-exp,Avoiding UDFs,case0-2.py,894,772,1666
gemini-2.0-flash-exp,All,case0-2.py,1737,2567,4304
gemini-1.0-pro-002,RDD vs DataFrame,case0-3.py,1326,239,1565
gemini-1.0-pro-002,Coalesce vs Repartition,case0-3.py,1304,27,1331
gemini-1.0-pro-002,Map vs MapPartitions,case0-3.py,1293,224,1517
gemini-1.0-pro-002,Serialized Data Formats,case0-3.py,1337,255,1592
gemini-1.0-pro-002,Avoiding UDFs,case0-3.py,1303,30,1333
gemini-1.0-pro-002,All,case0-3.py,2146,133,2279
gemini-1.5-flash-002,RDD vs DataFrame,case0-3.py,1326,2003,3329
gemini-1.5-flash-002,Coalesce vs Repartition,case0-3.py,1304,31,1335
gemini-1.5-flash-002,Map vs MapPartitions,case0-3.py,1293,31,1324
gemini-1.5-flash-002,Serialized Data Formats,case0-3.py,1337,31,1368
gemini-1.5-flash-002,Avoiding UDFs,case0-3.py,1303,549,1852
gemini-1.5-flash-002,All,case0-3.py,2146,780,2926
gemini-2.0-flash-exp,RDD vs DataFrame,case0-3.py,1326,2690,4016
gemini-2.0-flash-exp,Coalesce vs Repartition,case0-3.py,1304,31,1335
gemini-2.0-flash-exp,Map vs MapPartitions,case0-3.py,1293,31,1324
gemini-2.0-flash-exp,Serialized Data Formats,case0-3.py,1337,31,1368
gemini-2.0-flash-exp,Avoiding UDFs,case0-3.py,1303,1114,2417
gemini-2.0-flash-exp,All,case0-3.py,2146,3378,5524
gemini-1.0-pro-002,RDD vs DataFrame,case0-4.py,637,365,1002
gemini-1.0-pro-002,Coalesce vs Repartition,case0-4.py,615,96,711
gemini-1.0-pro-002,Map vs MapPartitions,case0-4.py,604,335,939
gemini-1.0-pro-002,Serialized Data Formats,case0-4.py,648,270,918
gemini-1.0-pro-002,Avoiding UDFs,case0-4.py,614,210,824
gemini-1.0-pro-002,All,case0-4.py,1457,499,1956
gemini-1.5-flash-002,RDD vs DataFrame,case0-4.py,637,480,1117
gemini-1.5-flash-002,Coalesce vs Repartition,case0-4.py,615,31,646
gemini-1.5-flash-002,Map vs MapPartitions,case0-4.py,604,326,930
gemini-1.5-flash-002,Serialized Data Formats,case0-4.py,648,31,679
gemini-1.5-flash-002,Avoiding UDFs,case0-4.py,614,505,1119
gemini-1.5-flash-002,All,case0-4.py,1457,868,2325
gemini-2.0-flash-exp,RDD vs DataFrame,case0-4.py,637,453,1090
gemini-2.0-flash-exp,Coalesce vs Repartition,case0-4.py,615,31,646
gemini-2.0-flash-exp,Map vs MapPartitions,case0-4.py,604,314,918
gemini-2.0-flash-exp,Serialized Data Formats,case0-4.py,648,31,679
gemini-2.0-flash-exp,Avoiding UDFs,case0-4.py,614,363,977
gemini-2.0-flash-exp,All,case0-4.py,1457,886,2343
gemini-1.0-pro-002,RDD vs DataFrame,case0-5.py,637,317,954
gemini-1.0-pro-002,Coalesce vs Repartition,case0-5.py,615,95,710
gemini-1.0-pro-002,Map vs MapPartitions,case0-5.py,604,349,953
gemini-1.0-pro-002,Serialized Data Formats,case0-5.py,648,187,835
gemini-1.0-pro-002,Avoiding UDFs,case0-5.py,614,210,824
gemini-1.0-pro-002,All,case0-5.py,1457,227,1684
gemini-1.5-flash-002,RDD vs DataFrame,case0-5.py,637,499,1136
gemini-1.5-flash-002,Coalesce vs Repartition,case0-5.py,615,31,646
gemini-1.5-flash-002,Map vs MapPartitions,case0-5.py,604,352,956
gemini-1.5-flash-002,Serialized Data Formats,case0-5.py,648,31,679
gemini-1.5-flash-002,Avoiding UDFs,case0-5.py,614,503,1117
gemini-1.5-flash-002,All,case0-5.py,1457,665,2122
gemini-2.0-flash-exp,RDD vs DataFrame,case0-5.py,637,453,1090
gemini-2.0-flash-exp,Coalesce vs Repartition,case0-5.py,615,31,646
gemini-2.0-flash-exp,Map vs MapPartitions,case0-5.py,604,314,918
gemini-2.0-flash-exp,Serialized Data Formats,case0-5.py,648,31,679
gemini-2.0-flash-exp,Avoiding UDFs,case0-5.py,614,363,977
gemini-2.0-flash-exp,All,case0-5.py,1457,886,2343
gemini-1.0-pro-002,RDD vs DataFrame,case0-6.py,568,341,909
gemini-1.0-pro-002,Coalesce vs Repartition,case0-6.py,546,154,700
gemini-1.0-pro-002,Map vs MapPartitions,case0-6.py,535,298,833
gemini-1.0-pro-002,Serialized Data Formats,case0-6.py,579,363,942
gemini-1.0-pro-002,Avoiding UDFs,case0-6.py,545,130,675
gemini-1.0-pro-002,All,case0-6.py,1388,359,1747
gemini-1.5-flash-002,RDD vs DataFrame,case0-6.py,568,330,898
gemini-1.5-flash-002,Coalesce vs Repartition,case0-6.py,546,31,577
gemini-1.5-flash-002,Map vs MapPartitions,case0-6.py,535,31,566
gemini-1.5-flash-002,Serialized Data Formats,case0-6.py,579,31,610
gemini-1.5-flash-002,Avoiding UDFs,case0-6.py,545,401,946
gemini-1.5-flash-002,All,case0-6.py,1388,569,1957
gemini-2.0-flash-exp,RDD vs DataFrame,case0-6.py,568,486,1054
gemini-2.0-flash-exp,Coalesce vs Repartition,case0-6.py,546,31,577
gemini-2.0-flash-exp,Map vs MapPartitions,case0-6.py,535,31,566
gemini-2.0-flash-exp,Serialized Data Formats,case0-6.py,579,31,610
gemini-2.0-flash-exp,Avoiding UDFs,case0-6.py,545,312,857
gemini-2.0-flash-exp,All,case0-6.py,1388,395,1783
gemini-1.0-pro-002,RDD vs DataFrame,case0-7.py,906,769,1675
gemini-1.0-pro-002,Coalesce vs Repartition,case0-7.py,884,260,1144
gemini-1.0-pro-002,Map vs MapPartitions,case0-7.py,873,625,1498
gemini-1.0-pro-002,Serialized Data Formats,case0-7.py,917,523,1440
gemini-1.0-pro-002,Avoiding UDFs,case0-7.py,883,475,1358
gemini-1.0-pro-002,All,case0-7.py,1726,544,2270
gemini-1.5-flash-002,RDD vs DataFrame,case0-7.py,906,1230,2136
gemini-1.5-flash-002,Coalesce vs Repartition,case0-7.py,884,31,915
gemini-1.5-flash-002,Map vs MapPartitions,case0-7.py,873,972,1845
gemini-1.5-flash-002,Serialized Data Formats,case0-7.py,917,505,1422
gemini-1.5-flash-002,Avoiding UDFs,case0-7.py,883,515,1398
gemini-1.5-flash-002,All,case0-7.py,1726,2384,4110
gemini-2.0-flash-exp,RDD vs DataFrame,case0-7.py,906,1720,2626
gemini-2.0-flash-exp,Coalesce vs Repartition,case0-7.py,884,31,915
gemini-2.0-flash-exp,Map vs MapPartitions,case0-7.py,873,1425,2298
gemini-2.0-flash-exp,Serialized Data Formats,case0-7.py,917,312,1229
gemini-2.0-flash-exp,Avoiding UDFs,case0-7.py,883,1064,1947
gemini-2.0-flash-exp,All,case0-7.py,1726,2915,4641
gemini-1.0-pro-002,RDD vs DataFrame,case0-8.py,615,257,872
gemini-1.0-pro-002,Coalesce vs Repartition,case0-8.py,593,96,689
gemini-1.0-pro-002,Map vs MapPartitions,case0-8.py,582,132,714
gemini-1.0-pro-002,Serialized Data Formats,case0-8.py,626,117,743
gemini-1.0-pro-002,Avoiding UDFs,case0-8.py,592,111,703
gemini-1.0-pro-002,All,case0-8.py,1435,221,1656
gemini-1.5-flash-002,RDD vs DataFrame,case0-8.py,615,362,977
gemini-1.5-flash-002,Coalesce vs Repartition,case0-8.py,593,31,624
gemini-1.5-flash-002,Map vs MapPartitions,case0-8.py,582,31,613
gemini-1.5-flash-002,Serialized Data Formats,case0-8.py,626,31,657
gemini-1.5-flash-002,Avoiding UDFs,case0-8.py,592,307,899
gemini-1.5-flash-002,All,case0-8.py,1435,591,2026
gemini-2.0-flash-exp,RDD vs DataFrame,case0-8.py,615,389,1004
gemini-2.0-flash-exp,Coalesce vs Repartition,case0-8.py,593,31,624
gemini-2.0-flash-exp,Map vs MapPartitions,case0-8.py,582,31,613
gemini-2.0-flash-exp,Serialized Data Formats,case0-8.py,626,31,657
gemini-2.0-flash-exp,Avoiding UDFs,case0-8.py,592,273,865
gemini-2.0-flash-exp,All,case0-8.py,1435,364,1799
gemini-1.0-pro-002,RDD vs DataFrame,case0-9.py,711,599,1310
gemini-1.0-pro-002,Coalesce vs Repartition,case0-9.py,689,293,982
gemini-1.0-pro-002,Map vs MapPartitions,case0-9.py,678,361,1039
gemini-1.0-pro-002,Serialized Data Formats,case0-9.py,722,266,988
gemini-1.0-pro-002,Avoiding UDFs,case0-9.py,688,294,982
gemini-1.0-pro-002,All,case0-9.py,1531,798,2329
gemini-1.5-flash-002,RDD vs DataFrame,case0-9.py,711,805,1516
gemini-1.5-flash-002,Coalesce vs Repartition,case0-9.py,689,31,720
gemini-1.5-flash-002,Map vs MapPartitions,case0-9.py,678,385,1063
gemini-1.5-flash-002,Serialized Data Formats,case0-9.py,722,431,1153
gemini-1.5-flash-002,Avoiding UDFs,case0-9.py,688,838,1526
gemini-1.5-flash-002,All,case0-9.py,1531,1243,2774
gemini-2.0-flash-exp,RDD vs DataFrame,case0-9.py,711,1166,1877
gemini-2.0-flash-exp,Coalesce vs Repartition,case0-9.py,689,31,720
gemini-2.0-flash-exp,Map vs MapPartitions,case0-9.py,678,451,1129
gemini-2.0-flash-exp,Serialized Data Formats,case0-9.py,722,720,1442
gemini-2.0-flash-exp,Avoiding UDFs,case0-9.py,688,890,1578
gemini-2.0-flash-exp,All,case0-9.py,1531,1373,2904
gemini-1.0-pro-002,RDD vs DataFrame,case01.py,739,310,1049
gemini-1.0-pro-002,Coalesce vs Repartition,case01.py,717,198,915
gemini-1.0-pro-002,Map vs MapPartitions,case01.py,706,273,979
gemini-1.0-pro-002,Serialized Data Formats,case01.py,750,405,1155
gemini-1.0-pro-002,Avoiding UDFs,case01.py,716,308,1024
gemini-1.0-pro-002,All,case01.py,1559,414,1973
gemini-1.5-flash-002,RDD vs DataFrame,case01.py,739,541,1280
gemini-1.5-flash-002,Coalesce vs Repartition,case01.py,717,280,997
gemini-1.5-flash-002,Map vs MapPartitions,case01.py,706,234,940
gemini-1.5-flash-002,Serialized Data Formats,case01.py,750,456,1206
gemini-1.5-flash-002,Avoiding UDFs,case01.py,716,31,747
gemini-1.5-flash-002,All,case01.py,1559,854,2413
gemini-2.0-flash-exp,RDD vs DataFrame,case01.py,739,571,1310
gemini-2.0-flash-exp,Coalesce vs Repartition,case01.py,717,285,1002
gemini-2.0-flash-exp,Map vs MapPartitions,case01.py,706,289,995
gemini-2.0-flash-exp,Serialized Data Formats,case01.py,750,657,1407
gemini-2.0-flash-exp,Avoiding UDFs,case01.py,716,407,1123
gemini-2.0-flash-exp,All,case01.py,1559,885,2444
gemini-1.0-pro-002,RDD vs DataFrame,case012.py,806,592,1398
gemini-1.0-pro-002,Coalesce vs Repartition,case012.py,784,210,994
gemini-1.0-pro-002,Map vs MapPartitions,case012.py,773,204,977
gemini-1.0-pro-002,Serialized Data Formats,case012.py,817,468,1285
gemini-1.0-pro-002,Avoiding UDFs,case012.py,783,30,813
gemini-1.0-pro-002,All,case012.py,1626,594,2220
gemini-1.5-flash-002,RDD vs DataFrame,case012.py,806,492,1298
gemini-1.5-flash-002,Coalesce vs Repartition,case012.py,784,335,1119
gemini-1.5-flash-002,Map vs MapPartitions,case012.py,773,370,1143
gemini-1.5-flash-002,Serialized Data Formats,case012.py,817,486,1303
gemini-1.5-flash-002,Avoiding UDFs,case012.py,783,31,814
gemini-1.5-flash-002,All,case012.py,1626,908,2534
gemini-2.0-flash-exp,RDD vs DataFrame,case012.py,806,771,1577
gemini-2.0-flash-exp,Coalesce vs Repartition,case012.py,784,287,1071
gemini-2.0-flash-exp,Map vs MapPartitions,case012.py,773,420,1193
gemini-2.0-flash-exp,Serialized Data Formats,case012.py,817,648,1465
gemini-2.0-flash-exp,Avoiding UDFs,case012.py,783,31,814
gemini-2.0-flash-exp,All,case012.py,1626,1133,2759
gemini-1.0-pro-002,RDD vs DataFrame,case0123.py,847,513,1360
gemini-1.0-pro-002,Coalesce vs Repartition,case0123.py,825,214,1039
gemini-1.0-pro-002,Map vs MapPartitions,case0123.py,814,379,1193
gemini-1.0-pro-002,Serialized Data Formats,case0123.py,858,564,1422
gemini-1.0-pro-002,Avoiding UDFs,case0123.py,824,561,1385
gemini-1.0-pro-002,All,case0123.py,1667,612,2279
gemini-1.5-flash-002,RDD vs DataFrame,case0123.py,847,750,1597
gemini-1.5-flash-002,Coalesce vs Repartition,case0123.py,825,314,1139
gemini-1.5-flash-002,Map vs MapPartitions,case0123.py,814,364,1178
gemini-1.5-flash-002,Serialized Data Formats,case0123.py,858,560,1418
gemini-1.5-flash-002,Avoiding UDFs,case0123.py,824,31,855
gemini-1.5-flash-002,All,case0123.py,1667,1189,2856
gemini-2.0-flash-exp,RDD vs DataFrame,case0123.py,847,784,1631
gemini-2.0-flash-exp,Coalesce vs Repartition,case0123.py,825,8192,9017
gemini-2.0-flash-exp,Map vs MapPartitions,case0123.py,814,389,1203
gemini-2.0-flash-exp,Serialized Data Formats,case0123.py,858,482,1340
gemini-2.0-flash-exp,Avoiding UDFs,case0123.py,824,31,855
gemini-2.0-flash-exp,All,case0123.py,1667,1264,2931
gemini-1.0-pro-002,RDD vs DataFrame,case01234.py,852,849,1701
gemini-1.0-pro-002,Coalesce vs Repartition,case01234.py,830,202,1032
gemini-1.0-pro-002,Map vs MapPartitions,case01234.py,819,314,1133
gemini-1.0-pro-002,Serialized Data Formats,case01234.py,863,299,1162
gemini-1.0-pro-002,Avoiding UDFs,case01234.py,829,211,1040
gemini-1.0-pro-002,All,case01234.py,1672,745,2417
gemini-1.5-flash-002,RDD vs DataFrame,case01234.py,852,568,1420
gemini-1.5-flash-002,Coalesce vs Repartition,case01234.py,830,329,1159
gemini-1.5-flash-002,Map vs MapPartitions,case01234.py,819,416,1235
gemini-1.5-flash-002,Serialized Data Formats,case01234.py,863,278,1141
gemini-1.5-flash-002,Avoiding UDFs,case01234.py,829,257,1086
gemini-1.5-flash-002,All,case01234.py,1672,831,2503
gemini-2.0-flash-exp,RDD vs DataFrame,case01234.py,852,845,1697
gemini-2.0-flash-exp,Coalesce vs Repartition,case01234.py,830,303,1133
gemini-2.0-flash-exp,Map vs MapPartitions,case01234.py,819,585,1404
gemini-2.0-flash-exp,Serialized Data Formats,case01234.py,863,437,1300
gemini-2.0-flash-exp,Avoiding UDFs,case01234.py,829,252,1081
gemini-2.0-flash-exp,All,case01234.py,1672,1202,2874
gemini-1.0-pro-002,RDD vs DataFrame,case013.py,800,343,1143
gemini-1.0-pro-002,Coalesce vs Repartition,case013.py,778,233,1011
gemini-1.0-pro-002,Map vs MapPartitions,case013.py,767,283,1050
gemini-1.0-pro-002,Serialized Data Formats,case013.py,811,599,1410
gemini-1.0-pro-002,Avoiding UDFs,case013.py,777,260,1037
gemini-1.0-pro-002,All,case013.py,1620,496,2116
gemini-1.5-flash-002,RDD vs DataFrame,case013.py,800,417,1217
gemini-1.5-flash-002,Coalesce vs Repartition,case013.py,778,310,1088
gemini-1.5-flash-002,Map vs MapPartitions,case013.py,767,232,999
gemini-1.5-flash-002,Serialized Data Formats,case013.py,811,453,1264
gemini-1.5-flash-002,Avoiding UDFs,case013.py,777,31,808
gemini-1.5-flash-002,All,case013.py,1620,751,2371
gemini-2.0-flash-exp,RDD vs DataFrame,case013.py,800,756,1556
gemini-2.0-flash-exp,Coalesce vs Repartition,case013.py,778,263,1041
gemini-2.0-flash-exp,Map vs MapPartitions,case013.py,767,275,1042
gemini-2.0-flash-exp,Serialized Data Formats,case013.py,811,433,1244
gemini-2.0-flash-exp,Avoiding UDFs,case013.py,777,31,808
gemini-2.0-flash-exp,All,case013.py,1620,1032,2652
gemini-1.0-pro-002,RDD vs DataFrame,case014.py,881,332,1213
gemini-1.0-pro-002,Coalesce vs Repartition,case014.py,859,189,1048
gemini-1.0-pro-002,Map vs MapPartitions,case014.py,848,231,1079
gemini-1.0-pro-002,Serialized Data Formats,case014.py,892,318,1210
gemini-1.0-pro-002,Avoiding UDFs,case014.py,858,241,1099
gemini-1.0-pro-002,All,case014.py,1701,737,2438
gemini-1.5-flash-002,RDD vs DataFrame,case014.py,881,471,1352
gemini-1.5-flash-002,Coalesce vs Repartition,case014.py,859,327,1186
gemini-1.5-flash-002,Map vs MapPartitions,case014.py,848,213,1061
gemini-1.5-flash-002,Serialized Data Formats,case014.py,892,408,1300
gemini-1.5-flash-002,Avoiding UDFs,case014.py,858,372,1230
gemini-1.5-flash-002,All,case014.py,1701,923,2624
gemini-2.0-flash-exp,RDD vs DataFrame,case014.py,881,560,1441
gemini-2.0-flash-exp,Coalesce vs Repartition,case014.py,859,216,1075
gemini-2.0-flash-exp,Map vs MapPartitions,case014.py,848,290,1138
gemini-2.0-flash-exp,Serialized Data Formats,case014.py,892,545,1437
gemini-2.0-flash-exp,Avoiding UDFs,case014.py,858,342,1200
gemini-2.0-flash-exp,All,case014.py,1701,1090,2791
gemini-1.0-pro-002,RDD vs DataFrame,case02.py,724,638,1362
gemini-1.0-pro-002,Coalesce vs Repartition,case02.py,702,103,805
gemini-1.0-pro-002,Map vs MapPartitions,case02.py,691,365,1056
gemini-1.0-pro-002,Serialized Data Formats,case02.py,735,232,967
gemini-1.0-pro-002,Avoiding UDFs,case02.py,701,264,965
gemini-1.0-pro-002,All,case02.py,1544,583,2127
gemini-1.5-flash-002,RDD vs DataFrame,case02.py,724,599,1323
gemini-1.5-flash-002,Coalesce vs Repartition,case02.py,702,31,733
gemini-1.5-flash-002,Map vs MapPartitions,case02.py,691,404,1095
gemini-1.5-flash-002,Serialized Data Formats,case02.py,735,488,1223
gemini-1.5-flash-002,Avoiding UDFs,case02.py,701,633,1334
gemini-1.5-flash-002,All,case02.py,1544,955,2499
gemini-2.0-flash-exp,RDD vs DataFrame,case02.py,724,591,1315
gemini-2.0-flash-exp,Coalesce vs Repartition,case02.py,702,31,733
gemini-2.0-flash-exp,Map vs MapPartitions,case02.py,691,452,1143
gemini-2.0-flash-exp,Serialized Data Formats,case02.py,735,573,1308
gemini-2.0-flash-exp,Avoiding UDFs,case02.py,701,31,732
gemini-2.0-flash-exp,All,case02.py,1544,997,2541
gemini-1.0-pro-002,RDD vs DataFrame,case023.py,830,592,1422
gemini-1.0-pro-002,Coalesce vs Repartition,case023.py,808,140,948
gemini-1.0-pro-002,Map vs MapPartitions,case023.py,797,476,1273
gemini-1.0-pro-002,Serialized Data Formats,case023.py,841,589,1430
gemini-1.0-pro-002,Avoiding UDFs,case023.py,807,397,1204
gemini-1.0-pro-002,All,case023.py,1650,619,2269
gemini-1.5-flash-002,RDD vs DataFrame,case023.py,830,521,1351
gemini-1.5-flash-002,Coalesce vs Repartition,case023.py,808,31,839
gemini-1.5-flash-002,Map vs MapPartitions,case023.py,797,401,1198
gemini-1.5-flash-002,Serialized Data Formats,case023.py,841,513,1354
gemini-1.5-flash-002,Avoiding UDFs,case023.py,807,31,838
gemini-1.5-flash-002,All,case023.py,1650,846,2496
gemini-2.0-flash-exp,RDD vs DataFrame,case023.py,830,580,1410
gemini-2.0-flash-exp,Coalesce vs Repartition,case023.py,808,31,839
gemini-2.0-flash-exp,Map vs MapPartitions,case023.py,797,492,1289
gemini-2.0-flash-exp,Serialized Data Formats,case023.py,841,495,1336
gemini-2.0-flash-exp,Avoiding UDFs,case023.py,807,31,838
gemini-2.0-flash-exp,All,case023.py,1650,1054,2704
gemini-1.0-pro-002,RDD vs DataFrame,case03.py,703,483,1186
gemini-1.0-pro-002,Coalesce vs Repartition,case03.py,681,175,856
gemini-1.0-pro-002,Map vs MapPartitions,case03.py,670,350,1020
gemini-1.0-pro-002,Serialized Data Formats,case03.py,714,461,1175
gemini-1.0-pro-002,Avoiding UDFs,case03.py,680,314,994
gemini-1.0-pro-002,All,case03.py,1523,506,2029
gemini-1.5-flash-002,RDD vs DataFrame,case03.py,703,556,1259
gemini-1.5-flash-002,Coalesce vs Repartition,case03.py,681,31,712
gemini-1.5-flash-002,Map vs MapPartitions,case03.py,670,370,1040
gemini-1.5-flash-002,Serialized Data Formats,case03.py,714,438,1152
gemini-1.5-flash-002,Avoiding UDFs,case03.py,680,31,711
gemini-1.5-flash-002,All,case03.py,1523,988,2511
gemini-2.0-flash-exp,RDD vs DataFrame,case03.py,703,614,1317
gemini-2.0-flash-exp,Coalesce vs Repartition,case03.py,681,31,712
gemini-2.0-flash-exp,Map vs MapPartitions,case03.py,670,469,1139
gemini-2.0-flash-exp,Serialized Data Formats,case03.py,714,466,1180
gemini-2.0-flash-exp,Avoiding UDFs,case03.py,680,31,711
gemini-2.0-flash-exp,All,case03.py,1523,773,2296
gemini-1.0-pro-002,RDD vs DataFrame,case04.py,784,439,1223
gemini-1.0-pro-002,Coalesce vs Repartition,case04.py,762,30,792
gemini-1.0-pro-002,Map vs MapPartitions,case04.py,751,261,1012
gemini-1.0-pro-002,Serialized Data Formats,case04.py,795,330,1125
gemini-1.0-pro-002,Avoiding UDFs,case04.py,761,261,1022
gemini-1.0-pro-002,All,case04.py,1604,500,2104
gemini-1.5-flash-002,RDD vs DataFrame,case04.py,784,421,1205
gemini-1.5-flash-002,Coalesce vs Repartition,case04.py,762,31,793
gemini-1.5-flash-002,Map vs MapPartitions,case04.py,751,243,994
gemini-1.5-flash-002,Serialized Data Formats,case04.py,795,425,1220
gemini-1.5-flash-002,Avoiding UDFs,case04.py,761,234,995
gemini-1.5-flash-002,All,case04.py,1604,1096,2700
gemini-2.0-flash-exp,RDD vs DataFrame,case04.py,784,584,1368
gemini-2.0-flash-exp,Coalesce vs Repartition,case04.py,762,31,793
gemini-2.0-flash-exp,Map vs MapPartitions,case04.py,751,255,1006
gemini-2.0-flash-exp,Serialized Data Formats,case04.py,795,566,1361
gemini-2.0-flash-exp,Avoiding UDFs,case04.py,761,265,1026
gemini-2.0-flash-exp,All,case04.py,1604,914,2518
gemini-1.0-pro-002,RDD vs DataFrame,case1-1.py,1241,281,1522
gemini-1.0-pro-002,Coalesce vs Repartition,case1-1.py,1219,345,1564
gemini-1.0-pro-002,Map vs MapPartitions,case1-1.py,1208,731,1939
gemini-1.0-pro-002,Serialized Data Formats,case1-1.py,1252,324,1576
gemini-1.0-pro-002,Avoiding UDFs,case1-1.py,1218,30,1248
gemini-1.0-pro-002,All,case1-1.py,2061,317,2378
gemini-1.5-flash-002,RDD vs DataFrame,case1-1.py,1241,31,1272
gemini-1.5-flash-002,Coalesce vs Repartition,case1-1.py,1219,419,1638
gemini-1.5-flash-002,Map vs MapPartitions,case1-1.py,1208,31,1239
gemini-1.5-flash-002,Serialized Data Formats,case1-1.py,1252,730,1982
gemini-1.5-flash-002,Avoiding UDFs,case1-1.py,1218,31,1249
gemini-1.5-flash-002,All,case1-1.py,2061,629,2690
gemini-2.0-flash-exp,RDD vs DataFrame,case1-1.py,1241,31,1272
gemini-2.0-flash-exp,Coalesce vs Repartition,case1-1.py,1219,568,1787
gemini-2.0-flash-exp,Map vs MapPartitions,case1-1.py,1208,31,1239
gemini-2.0-flash-exp,Serialized Data Formats,case1-1.py,1252,715,1967
gemini-2.0-flash-exp,Avoiding UDFs,case1-1.py,1218,31,1249
gemini-2.0-flash-exp,All,case1-1.py,2061,878,2939
gemini-1.0-pro-002,RDD vs DataFrame,case1-10.py,809,485,1294
gemini-1.0-pro-002,Coalesce vs Repartition,case1-10.py,787,392,1179
gemini-1.0-pro-002,Map vs MapPartitions,case1-10.py,776,325,1101
gemini-1.0-pro-002,Serialized Data Formats,case1-10.py,820,275,1095
gemini-1.0-pro-002,Avoiding UDFs,case1-10.py,786,221,1007
gemini-1.0-pro-002,All,case1-10.py,1629,360,1989
gemini-1.5-flash-002,RDD vs DataFrame,case1-10.py,809,551,1360
gemini-1.5-flash-002,Coalesce vs Repartition,case1-10.py,787,424,1211
gemini-1.5-flash-002,Map vs MapPartitions,case1-10.py,776,31,807
gemini-1.5-flash-002,Serialized Data Formats,case1-10.py,820,712,1532
gemini-1.5-flash-002,Avoiding UDFs,case1-10.py,786,556,1342
gemini-1.5-flash-002,All,case1-10.py,1629,810,2439
gemini-2.0-flash-exp,RDD vs DataFrame,case1-10.py,809,812,1621
gemini-2.0-flash-exp,Coalesce vs Repartition,case1-10.py,787,406,1193
gemini-2.0-flash-exp,Map vs MapPartitions,case1-10.py,776,31,807
gemini-2.0-flash-exp,Serialized Data Formats,case1-10.py,820,853,1673
gemini-2.0-flash-exp,Avoiding UDFs,case1-10.py,786,638,1424
gemini-2.0-flash-exp,All,case1-10.py,1629,623,2252
gemini-1.0-pro-002,RDD vs DataFrame,case1-11.py,2380,1906,4286
gemini-1.0-pro-002,Coalesce vs Repartition,case1-11.py,2358,237,2595
gemini-1.0-pro-002,Map vs MapPartitions,case1-11.py,2347,335,2682
gemini-1.0-pro-002,Serialized Data Formats,case1-11.py,2391,370,2761
gemini-1.0-pro-002,Avoiding UDFs,case1-11.py,2357,476,2833
gemini-1.0-pro-002,All,case1-11.py,3200,414,3614
gemini-1.5-flash-002,RDD vs DataFrame,case1-11.py,2380,31,2411
gemini-1.5-flash-002,Coalesce vs Repartition,case1-11.py,2358,406,2764
gemini-1.5-flash-002,Map vs MapPartitions,case1-11.py,2347,31,2378
gemini-1.5-flash-002,Serialized Data Formats,case1-11.py,2391,503,2894
gemini-1.5-flash-002,Avoiding UDFs,case1-11.py,2357,599,2956
gemini-1.5-flash-002,All,case1-11.py,3200,479,3679
gemini-2.0-flash-exp,RDD vs DataFrame,case1-11.py,2380,31,2411
gemini-2.0-flash-exp,Coalesce vs Repartition,case1-11.py,2358,425,2783
gemini-2.0-flash-exp,Map vs MapPartitions,case1-11.py,2347,31,2378
gemini-2.0-flash-exp,Serialized Data Formats,case1-11.py,2391,913,3304
gemini-2.0-flash-exp,Avoiding UDFs,case1-11.py,2357,321,2678
gemini-2.0-flash-exp,All,case1-11.py,3200,790,3990
gemini-1.0-pro-002,RDD vs DataFrame,case1-2.py,1238,301,1539
gemini-1.0-pro-002,Coalesce vs Repartition,case1-2.py,1216,310,1526
gemini-1.0-pro-002,Map vs MapPartitions,case1-2.py,1205,510,1715
gemini-1.0-pro-002,Serialized Data Formats,case1-2.py,1249,306,1555
gemini-1.0-pro-002,Avoiding UDFs,case1-2.py,1215,30,1245
gemini-1.0-pro-002,All,case1-2.py,2058,399,2457
gemini-1.5-flash-002,RDD vs DataFrame,case1-2.py,1238,31,1269
gemini-1.5-flash-002,Coalesce vs Repartition,case1-2.py,1216,344,1560
gemini-1.5-flash-002,Map vs MapPartitions,case1-2.py,1205,31,1236
gemini-1.5-flash-002,Serialized Data Formats,case1-2.py,1249,462,1711
gemini-1.5-flash-002,Avoiding UDFs,case1-2.py,1215,31,1246
gemini-1.5-flash-002,All,case1-2.py,2058,583,2641
gemini-2.0-flash-exp,RDD vs DataFrame,case1-2.py,1238,31,1269
gemini-2.0-flash-exp,Coalesce vs Repartition,case1-2.py,1216,374,1590
gemini-2.0-flash-exp,Map vs MapPartitions,case1-2.py,1205,31,1236
gemini-2.0-flash-exp,Serialized Data Formats,case1-2.py,1249,548,1797
gemini-2.0-flash-exp,Avoiding UDFs,case1-2.py,1215,31,1246
gemini-2.0-flash-exp,All,case1-2.py,2058,653,2711
gemini-1.0-pro-002,RDD vs DataFrame,case1-3.py,1242,30,1272
gemini-1.0-pro-002,Coalesce vs Repartition,case1-3.py,1220,394,1614
gemini-1.0-pro-002,Map vs MapPartitions,case1-3.py,1209,744,1953
gemini-1.0-pro-002,Serialized Data Formats,case1-3.py,1253,522,1775
gemini-1.0-pro-002,Avoiding UDFs,case1-3.py,1219,202,1421
gemini-1.0-pro-002,All,case1-3.py,2062,517,2579
gemini-1.5-flash-002,RDD vs DataFrame,case1-3.py,1242,31,1273
gemini-1.5-flash-002,Coalesce vs Repartition,case1-3.py,1220,498,1718
gemini-1.5-flash-002,Map vs MapPartitions,case1-3.py,1209,31,1240
gemini-1.5-flash-002,Serialized Data Formats,case1-3.py,1253,470,1723
gemini-1.5-flash-002,Avoiding UDFs,case1-3.py,1219,2524,3743
gemini-1.5-flash-002,All,case1-3.py,2062,672,2734
gemini-2.0-flash-exp,RDD vs DataFrame,case1-3.py,1242,31,1273
gemini-2.0-flash-exp,Coalesce vs Repartition,case1-3.py,1220,8189,9409
gemini-2.0-flash-exp,Map vs MapPartitions,case1-3.py,1209,31,1240
gemini-2.0-flash-exp,Serialized Data Formats,case1-3.py,1253,614,1867
gemini-2.0-flash-exp,Avoiding UDFs,case1-3.py,1219,31,1250
gemini-2.0-flash-exp,All,case1-3.py,2062,835,2897
gemini-1.0-pro-002,RDD vs DataFrame,case1-4.py,1286,295,1581
gemini-1.0-pro-002,Coalesce vs Repartition,case1-4.py,1264,223,1487
gemini-1.0-pro-002,Map vs MapPartitions,case1-4.py,1253,621,1874
gemini-1.0-pro-002,Serialized Data Formats,case1-4.py,1297,480,1777
gemini-1.0-pro-002,Avoiding UDFs,case1-4.py,1263,207,1470
gemini-1.0-pro-002,All,case1-4.py,2106,327,2433
gemini-1.5-flash-002,RDD vs DataFrame,case1-4.py,1286,31,1317
gemini-1.5-flash-002,Coalesce vs Repartition,case1-4.py,1264,416,1680
gemini-1.5-flash-002,Map vs MapPartitions,case1-4.py,1253,31,1284
gemini-1.5-flash-002,Serialized Data Formats,case1-4.py,1297,522,1819
gemini-1.5-flash-002,Avoiding UDFs,case1-4.py,1263,31,1294
gemini-1.5-flash-002,All,case1-4.py,2106,816,2922
gemini-2.0-flash-exp,RDD vs DataFrame,case1-4.py,1286,31,1317
gemini-2.0-flash-exp,Coalesce vs Repartition,case1-4.py,1264,242,1506
gemini-2.0-flash-exp,Map vs MapPartitions,case1-4.py,1253,31,1284
gemini-2.0-flash-exp,Serialized Data Formats,case1-4.py,1297,692,1989
gemini-2.0-flash-exp,Avoiding UDFs,case1-4.py,1263,31,1294
gemini-2.0-flash-exp,All,case1-4.py,2106,751,2857
gemini-1.0-pro-002,RDD vs DataFrame,case1-5.py,1282,247,1529
gemini-1.0-pro-002,Coalesce vs Repartition,case1-5.py,1260,394,1654
gemini-1.0-pro-002,Map vs MapPartitions,case1-5.py,1249,760,2009
gemini-1.0-pro-002,Serialized Data Formats,case1-5.py,1293,478,1771
gemini-1.0-pro-002,Avoiding UDFs,case1-5.py,1259,207,1466
gemini-1.0-pro-002,All,case1-5.py,2102,268,2370
gemini-1.5-flash-002,RDD vs DataFrame,case1-5.py,1282,31,1313
gemini-1.5-flash-002,Coalesce vs Repartition,case1-5.py,1260,371,1631
gemini-1.5-flash-002,Map vs MapPartitions,case1-5.py,1249,31,1280
gemini-1.5-flash-002,Serialized Data Formats,case1-5.py,1293,558,1851
gemini-1.5-flash-002,Avoiding UDFs,case1-5.py,1259,31,1290
gemini-1.5-flash-002,All,case1-5.py,2102,830,2932
gemini-2.0-flash-exp,RDD vs DataFrame,case1-5.py,1282,31,1313
gemini-2.0-flash-exp,Coalesce vs Repartition,case1-5.py,1260,400,1660
gemini-2.0-flash-exp,Map vs MapPartitions,case1-5.py,1249,31,1280
gemini-2.0-flash-exp,Serialized Data Formats,case1-5.py,1293,607,1900
gemini-2.0-flash-exp,Avoiding UDFs,case1-5.py,1259,31,1290
gemini-2.0-flash-exp,All,case1-5.py,2102,690,2792
gemini-1.0-pro-002,RDD vs DataFrame,case1-6.py,1284,248,1532
gemini-1.0-pro-002,Coalesce vs Repartition,case1-6.py,1262,448,1710
gemini-1.0-pro-002,Map vs MapPartitions,case1-6.py,1251,312,1563
gemini-1.0-pro-002,Serialized Data Formats,case1-6.py,1295,479,1774
gemini-1.0-pro-002,Avoiding UDFs,case1-6.py,1261,233,1494
gemini-1.0-pro-002,All,case1-6.py,2104,330,2434
gemini-1.5-flash-002,RDD vs DataFrame,case1-6.py,1284,31,1315
gemini-1.5-flash-002,Coalesce vs Repartition,case1-6.py,1262,428,1690
gemini-1.5-flash-002,Map vs MapPartitions,case1-6.py,1251,31,1282
gemini-1.5-flash-002,Serialized Data Formats,case1-6.py,1295,617,1912
gemini-1.5-flash-002,Avoiding UDFs,case1-6.py,1261,31,1292
gemini-1.5-flash-002,All,case1-6.py,2104,871,2975
gemini-2.0-flash-exp,RDD vs DataFrame,case1-6.py,1284,31,1315
gemini-2.0-flash-exp,Coalesce vs Repartition,case1-6.py,1262,454,1716
gemini-2.0-flash-exp,Map vs MapPartitions,case1-6.py,1251,31,1282
gemini-2.0-flash-exp,Serialized Data Formats,case1-6.py,1295,688,1983
gemini-2.0-flash-exp,Avoiding UDFs,case1-6.py,1261,31,1292
gemini-2.0-flash-exp,All,case1-6.py,2104,786,2890
gemini-1.0-pro-002,RDD vs DataFrame,case1-7.py,1132,336,1468
gemini-1.0-pro-002,Coalesce vs Repartition,case1-7.py,1110,304,1414
gemini-1.0-pro-002,Map vs MapPartitions,case1-7.py,1099,153,1252
gemini-1.0-pro-002,Serialized Data Formats,case1-7.py,1143,118,1261
gemini-1.0-pro-002,Avoiding UDFs,case1-7.py,1109,501,1610
gemini-1.0-pro-002,All,case1-7.py,1952,293,2245
gemini-1.5-flash-002,RDD vs DataFrame,case1-7.py,1132,31,1163
gemini-1.5-flash-002,Coalesce vs Repartition,case1-7.py,1110,278,1388
gemini-1.5-flash-002,Map vs MapPartitions,case1-7.py,1099,31,1130
gemini-1.5-flash-002,Serialized Data Formats,case1-7.py,1143,31,1174
gemini-1.5-flash-002,Avoiding UDFs,case1-7.py,1109,31,1140
gemini-1.5-flash-002,All,case1-7.py,1952,544,2496
gemini-2.0-flash-exp,RDD vs DataFrame,case1-7.py,1132,264,1396
gemini-2.0-flash-exp,Coalesce vs Repartition,case1-7.py,1110,334,1444
gemini-2.0-flash-exp,Map vs MapPartitions,case1-7.py,1099,347,1446
gemini-2.0-flash-exp,Serialized Data Formats,case1-7.py,1143,31,1174
gemini-2.0-flash-exp,Avoiding UDFs,case1-7.py,1109,31,1140
gemini-2.0-flash-exp,All,case1-7.py,1952,480,2432
gemini-1.0-pro-002,RDD vs DataFrame,case1-8.py,2678,268,2946
gemini-1.0-pro-002,Coalesce vs Repartition,case1-8.py,2656,405,3061
gemini-1.0-pro-002,Map vs MapPartitions,case1-8.py,2645,332,2977
gemini-1.0-pro-002,Serialized Data Formats,case1-8.py,2689,613,3302
gemini-1.0-pro-002,Avoiding UDFs,case1-8.py,2655,271,2926
gemini-1.0-pro-002,All,case1-8.py,3498,134,3632
gemini-1.5-flash-002,RDD vs DataFrame,case1-8.py,2678,31,2709
gemini-1.5-flash-002,Coalesce vs Repartition,case1-8.py,2656,535,3191
gemini-1.5-flash-002,Map vs MapPartitions,case1-8.py,2645,31,2676
gemini-1.5-flash-002,Serialized Data Formats,case1-8.py,2689,519,3208
gemini-1.5-flash-002,Avoiding UDFs,case1-8.py,2655,31,2686
gemini-1.5-flash-002,All,case1-8.py,3498,677,4175
gemini-2.0-flash-exp,RDD vs DataFrame,case1-8.py,2678,31,2709
gemini-2.0-flash-exp,Coalesce vs Repartition,case1-8.py,2656,490,3146
gemini-2.0-flash-exp,Map vs MapPartitions,case1-8.py,2645,31,2676
gemini-2.0-flash-exp,Serialized Data Formats,case1-8.py,2689,272,2961
gemini-2.0-flash-exp,Avoiding UDFs,case1-8.py,2655,209,2864
gemini-2.0-flash-exp,All,case1-8.py,3498,302,3800
gemini-1.0-pro-002,RDD vs DataFrame,case1-9.py,986,304,1290
gemini-1.0-pro-002,Coalesce vs Repartition,case1-9.py,964,306,1270
gemini-1.0-pro-002,Map vs MapPartitions,case1-9.py,953,423,1376
gemini-1.0-pro-002,Serialized Data Formats,case1-9.py,997,245,1242
gemini-1.0-pro-002,Avoiding UDFs,case1-9.py,963,303,1266
gemini-1.0-pro-002,All,case1-9.py,1806,407,2213
gemini-1.5-flash-002,RDD vs DataFrame,case1-9.py,986,31,1017
gemini-1.5-flash-002,Coalesce vs Repartition,case1-9.py,964,307,1271
gemini-1.5-flash-002,Map vs MapPartitions,case1-9.py,953,31,984
gemini-1.5-flash-002,Serialized Data Formats,case1-9.py,997,446,1443
gemini-1.5-flash-002,Avoiding UDFs,case1-9.py,963,283,1246
gemini-1.5-flash-002,All,case1-9.py,1806,1296,3102
gemini-2.0-flash-exp,RDD vs DataFrame,case1-9.py,986,31,1017
gemini-2.0-flash-exp,Coalesce vs Repartition,case1-9.py,964,329,1293
gemini-2.0-flash-exp,Map vs MapPartitions,case1-9.py,953,31,984
gemini-2.0-flash-exp,Serialized Data Formats,case1-9.py,997,423,1420
gemini-2.0-flash-exp,Avoiding UDFs,case1-9.py,963,381,1344
gemini-2.0-flash-exp,All,case1-9.py,1806,609,2415
gemini-1.0-pro-002,RDD vs DataFrame,case12.py,770,323,1093
gemini-1.0-pro-002,Coalesce vs Repartition,case12.py,748,243,991
gemini-1.0-pro-002,Map vs MapPartitions,case12.py,737,311,1048
gemini-1.0-pro-002,Serialized Data Formats,case12.py,781,214,995
gemini-1.0-pro-002,Avoiding UDFs,case12.py,747,219,966
gemini-1.0-pro-002,All,case12.py,1590,576,2166
gemini-1.5-flash-002,RDD vs DataFrame,case12.py,770,288,1058
gemini-1.5-flash-002,Coalesce vs Repartition,case12.py,748,382,1130
gemini-1.5-flash-002,Map vs MapPartitions,case12.py,737,263,1000
gemini-1.5-flash-002,Serialized Data Formats,case12.py,781,31,812
gemini-1.5-flash-002,Avoiding UDFs,case12.py,747,358,1105
gemini-1.5-flash-002,All,case12.py,1590,953,2543
gemini-2.0-flash-exp,RDD vs DataFrame,case12.py,770,457,1227
gemini-2.0-flash-exp,Coalesce vs Repartition,case12.py,748,357,1105
gemini-2.0-flash-exp,Map vs MapPartitions,case12.py,737,314,1051
gemini-2.0-flash-exp,Serialized Data Formats,case12.py,781,31,812
gemini-2.0-flash-exp,Avoiding UDFs,case12.py,747,299,1046
gemini-2.0-flash-exp,All,case12.py,1590,802,2392
gemini-1.0-pro-002,RDD vs DataFrame,case13.py,771,346,1117
gemini-1.0-pro-002,Coalesce vs Repartition,case13.py,749,226,975
gemini-1.0-pro-002,Map vs MapPartitions,case13.py,738,277,1015
gemini-1.0-pro-002,Serialized Data Formats,case13.py,782,302,1084
gemini-1.0-pro-002,Avoiding UDFs,case13.py,748,30,778
gemini-1.0-pro-002,All,case13.py,1591,473,2064
gemini-1.5-flash-002,RDD vs DataFrame,case13.py,771,450,1221
gemini-1.5-flash-002,Coalesce vs Repartition,case13.py,749,287,1036
gemini-1.5-flash-002,Map vs MapPartitions,case13.py,738,31,769
gemini-1.5-flash-002,Serialized Data Formats,case13.py,782,311,1093
gemini-1.5-flash-002,Avoiding UDFs,case13.py,748,31,779
gemini-1.5-flash-002,All,case13.py,1591,618,2209
gemini-2.0-flash-exp,RDD vs DataFrame,case13.py,771,837,1608
gemini-2.0-flash-exp,Coalesce vs Repartition,case13.py,749,306,1055
gemini-2.0-flash-exp,Map vs MapPartitions,case13.py,738,31,769
gemini-2.0-flash-exp,Serialized Data Formats,case13.py,782,374,1156
gemini-2.0-flash-exp,Avoiding UDFs,case13.py,748,31,779
gemini-2.0-flash-exp,All,case13.py,1591,742,2333
gemini-1.0-pro-002,RDD vs DataFrame,case2-1.py,842,707,1549
gemini-1.0-pro-002,Coalesce vs Repartition,case2-1.py,820,109,929
gemini-1.0-pro-002,Map vs MapPartitions,case2-1.py,809,307,1116
gemini-1.0-pro-002,Serialized Data Formats,case2-1.py,853,297,1150
gemini-1.0-pro-002,Avoiding UDFs,case2-1.py,819,574,1393
gemini-1.0-pro-002,All,case2-1.py,1662,551,2213
gemini-1.5-flash-002,RDD vs DataFrame,case2-1.py,842,754,1596
gemini-1.5-flash-002,Coalesce vs Repartition,case2-1.py,820,31,851
gemini-1.5-flash-002,Map vs MapPartitions,case2-1.py,809,31,840
gemini-1.5-flash-002,Serialized Data Formats,case2-1.py,853,477,1330
gemini-1.5-flash-002,Avoiding UDFs,case2-1.py,819,536,1355
gemini-1.5-flash-002,All,case2-1.py,1662,963,2625
gemini-2.0-flash-exp,RDD vs DataFrame,case2-1.py,842,1118,1960
gemini-2.0-flash-exp,Coalesce vs Repartition,case2-1.py,820,31,851
gemini-2.0-flash-exp,Map vs MapPartitions,case2-1.py,809,31,840
gemini-2.0-flash-exp,Serialized Data Formats,case2-1.py,853,750,1603
gemini-2.0-flash-exp,Avoiding UDFs,case2-1.py,819,787,1606
gemini-2.0-flash-exp,All,case2-1.py,1662,1100,2762
gemini-1.0-pro-002,RDD vs DataFrame,case2-10.py,2290,1518,3808
gemini-1.0-pro-002,Coalesce vs Repartition,case2-10.py,2268,202,2470
gemini-1.0-pro-002,Map vs MapPartitions,case2-10.py,2257,492,2749
gemini-1.0-pro-002,Serialized Data Formats,case2-10.py,2301,536,2837
gemini-1.0-pro-002,Avoiding UDFs,case2-10.py,2267,732,2999
gemini-1.0-pro-002,All,case2-10.py,3110,3637,6747
gemini-1.5-flash-002,RDD vs DataFrame,case2-10.py,2290,1435,3725
gemini-1.5-flash-002,Coalesce vs Repartition,case2-10.py,2268,31,2299
gemini-1.5-flash-002,Map vs MapPartitions,case2-10.py,2257,1217,3474
gemini-1.5-flash-002,Serialized Data Formats,case2-10.py,2301,682,2983
gemini-1.5-flash-002,Avoiding UDFs,case2-10.py,2267,753,3020
gemini-1.5-flash-002,All,case2-10.py,3110,2809,5919
gemini-2.0-flash-exp,RDD vs DataFrame,case2-10.py,2290,3792,6082
gemini-2.0-flash-exp,Coalesce vs Repartition,case2-10.py,2268,31,2299
gemini-2.0-flash-exp,Map vs MapPartitions,case2-10.py,2257,1129,3386
gemini-2.0-flash-exp,Serialized Data Formats,case2-10.py,2301,1173,3474
gemini-2.0-flash-exp,Avoiding UDFs,case2-10.py,2267,1184,3451
gemini-2.0-flash-exp,All,case2-10.py,3110,4155,7265
gemini-1.0-pro-002,RDD vs DataFrame,case2-11.py,2207,447,2654
gemini-1.0-pro-002,Coalesce vs Repartition,case2-11.py,2185,236,2421
gemini-1.0-pro-002,Map vs MapPartitions,case2-11.py,2174,264,2438
gemini-1.0-pro-002,Serialized Data Formats,case2-11.py,2218,356,2574
gemini-1.0-pro-002,Avoiding UDFs,case2-11.py,2184,798,2982
gemini-1.0-pro-002,All,case2-11.py,3027,1594,4621
gemini-1.5-flash-002,RDD vs DataFrame,case2-11.py,2207,630,2837
gemini-1.5-flash-002,Coalesce vs Repartition,case2-11.py,2185,31,2216
gemini-1.5-flash-002,Map vs MapPartitions,case2-11.py,2174,266,2440
gemini-1.5-flash-002,Serialized Data Formats,case2-11.py,2218,338,2556
gemini-1.5-flash-002,Avoiding UDFs,case2-11.py,2184,960,3144
gemini-1.5-flash-002,All,case2-11.py,3027,1386,4413
gemini-2.0-flash-exp,RDD vs DataFrame,case2-11.py,2207,1292,3499
gemini-2.0-flash-exp,Coalesce vs Repartition,case2-11.py,2185,31,2216
gemini-2.0-flash-exp,Serialized Data Formats,case2-11.py,2218,1190,3408
gemini-2.0-flash-exp,Avoiding UDFs,case2-11.py,2184,876,3060
gemini-2.0-flash-exp,All,case2-11.py,3027,1645,4672
gemini-1.0-pro-002,RDD vs DataFrame,case2-12.py,4633,329,4962
gemini-1.0-pro-002,Coalesce vs Repartition,case2-12.py,4611,182,4793
gemini-1.0-pro-002,Map vs MapPartitions,case2-12.py,4600,301,4901
gemini-1.0-pro-002,Serialized Data Formats,case2-12.py,4644,399,5043
gemini-1.0-pro-002,Avoiding UDFs,case2-12.py,4610,270,4880
gemini-1.0-pro-002,All,case2-12.py,5453,769,6222
gemini-1.5-flash-002,RDD vs DataFrame,case2-12.py,4633,851,5484
gemini-1.5-flash-002,Coalesce vs Repartition,case2-12.py,4611,308,4919
gemini-1.5-flash-002,Map vs MapPartitions,case2-12.py,4600,145,4745
gemini-1.5-flash-002,Serialized Data Formats,case2-12.py,4644,663,5307
gemini-1.5-flash-002,Avoiding UDFs,case2-12.py,4610,507,5117
gemini-1.5-flash-002,All,case2-12.py,5453,1027,6480
gemini-2.0-flash-exp,RDD vs DataFrame,case2-12.py,4633,643,5276
gemini-2.0-flash-exp,Coalesce vs Repartition,case2-12.py,4611,296,4907
gemini-2.0-flash-exp,Map vs MapPartitions,case2-12.py,4600,402,5002
gemini-2.0-flash-exp,Serialized Data Formats,case2-12.py,4644,1605,6249
gemini-2.0-flash-exp,Avoiding UDFs,case2-12.py,4610,452,5062
gemini-2.0-flash-exp,All,case2-12.py,5453,1418,6871
gemini-1.0-pro-002,RDD vs DataFrame,case2-2.py,14578,1912,16490
gemini-1.0-pro-002,Coalesce vs Repartition,case2-2.py,14556,208,14764
gemini-1.0-pro-002,Map vs MapPartitions,case2-2.py,14545,642,15187
gemini-1.0-pro-002,Serialized Data Formats,case2-2.py,14589,310,14899
gemini-1.0-pro-002,Avoiding UDFs,case2-2.py,14555,219,14774
gemini-1.0-pro-002,All,case2-2.py,15398,1182,16580
gemini-1.5-flash-002,RDD vs DataFrame,case2-2.py,14578,1207,15785
gemini-1.5-flash-002,Coalesce vs Repartition,case2-2.py,14556,31,14587
gemini-1.5-flash-002,Map vs MapPartitions,case2-2.py,14545,527,15072
gemini-1.5-flash-002,Serialized Data Formats,case2-2.py,14589,623,15212
gemini-1.5-flash-002,Avoiding UDFs,case2-2.py,14555,1176,15731
gemini-1.5-flash-002,All,case2-2.py,15398,2407,17805
gemini-2.0-flash-exp,RDD vs DataFrame,case2-2.py,14578,8198,22776
gemini-2.0-flash-exp,Coalesce vs Repartition,case2-2.py,14556,31,14587
gemini-2.0-flash-exp,Map vs MapPartitions,case2-2.py,14545,251,14796
gemini-2.0-flash-exp,Serialized Data Formats,case2-2.py,14589,1010,15599
gemini-2.0-flash-exp,Avoiding UDFs,case2-2.py,14555,1422,15977
gemini-2.0-flash-exp,All,case2-2.py,15398,6738,22136
gemini-1.0-pro-002,RDD vs DataFrame,case2-3.py,3013,1251,4264
gemini-1.0-pro-002,Coalesce vs Repartition,case2-3.py,2991,425,3416
gemini-1.0-pro-002,Map vs MapPartitions,case2-3.py,2980,258,3238
gemini-1.0-pro-002,Serialized Data Formats,case2-3.py,3024,902,3926
gemini-1.0-pro-002,Avoiding UDFs,case2-3.py,2990,455,3445
gemini-1.0-pro-002,All,case2-3.py,3833,477,4310
gemini-1.5-flash-002,RDD vs DataFrame,case2-3.py,3013,2443,5456
gemini-1.5-flash-002,Coalesce vs Repartition,case2-3.py,2991,31,3022
gemini-1.5-flash-002,Map vs MapPartitions,case2-3.py,2980,1545,4525
gemini-1.5-flash-002,Serialized Data Formats,case2-3.py,3024,962,3986
gemini-1.5-flash-002,Avoiding UDFs,case2-3.py,2990,640,3630
gemini-1.5-flash-002,All,case2-3.py,3833,3450,7283
gemini-2.0-flash-exp,RDD vs DataFrame,case2-3.py,3013,6841,9854
gemini-2.0-flash-exp,Coalesce vs Repartition,case2-3.py,2991,31,3022
gemini-2.0-flash-exp,Map vs MapPartitions,case2-3.py,2980,1805,4785
gemini-2.0-flash-exp,Serialized Data Formats,case2-3.py,3024,3466,6490
gemini-2.0-flash-exp,Avoiding UDFs,case2-3.py,2990,1638,4628
gemini-2.0-flash-exp,All,case2-3.py,3833,4456,8289
gemini-1.0-pro-002,RDD vs DataFrame,case2-4.py,608,649,1257
gemini-1.0-pro-002,Coalesce vs Repartition,case2-4.py,586,30,616
gemini-1.0-pro-002,Map vs MapPartitions,case2-4.py,575,313,888
gemini-1.0-pro-002,Serialized Data Formats,case2-4.py,619,515,1134
gemini-1.0-pro-002,Avoiding UDFs,case2-4.py,585,331,916
gemini-1.0-pro-002,All,case2-4.py,1428,361,1789
gemini-1.5-flash-002,RDD vs DataFrame,case2-4.py,608,703,1311
gemini-1.5-flash-002,Coalesce vs Repartition,case2-4.py,586,31,617
gemini-1.5-flash-002,Map vs MapPartitions,case2-4.py,575,349,924
gemini-1.5-flash-002,Serialized Data Formats,case2-4.py,619,601,1220
gemini-1.5-flash-002,Avoiding UDFs,case2-4.py,585,431,1016
gemini-1.5-flash-002,All,case2-4.py,1428,899,2327
gemini-2.0-flash-exp,RDD vs DataFrame,case2-4.py,608,914,1522
gemini-2.0-flash-exp,Coalesce vs Repartition,case2-4.py,586,31,617
gemini-2.0-flash-exp,Map vs MapPartitions,case2-4.py,575,299,874
gemini-2.0-flash-exp,Serialized Data Formats,case2-4.py,619,585,1204
gemini-2.0-flash-exp,Avoiding UDFs,case2-4.py,585,358,943
gemini-2.0-flash-exp,All,case2-4.py,1428,1292,2720
gemini-1.0-pro-002,RDD vs DataFrame,case2-5.py,1275,821,2096
gemini-1.0-pro-002,Coalesce vs Repartition,case2-5.py,1253,278,1531
gemini-1.0-pro-002,Map vs MapPartitions,case2-5.py,1242,432,1674
gemini-1.0-pro-002,Serialized Data Formats,case2-5.py,1286,1466,2752
gemini-1.0-pro-002,Avoiding UDFs,case2-5.py,1252,727,1979
gemini-1.0-pro-002,All,case2-5.py,2095,672,2767
gemini-1.5-flash-002,RDD vs DataFrame,case2-5.py,1275,1122,2397
gemini-1.5-flash-002,Coalesce vs Repartition,case2-5.py,1253,31,1284
gemini-1.5-flash-002,Map vs MapPartitions,case2-5.py,1242,412,1654
gemini-1.5-flash-002,Serialized Data Formats,case2-5.py,1286,415,1701
gemini-1.5-flash-002,Avoiding UDFs,case2-5.py,1252,903,2155
gemini-1.5-flash-002,All,case2-5.py,2095,1768,3863
gemini-2.0-flash-exp,RDD vs DataFrame,case2-5.py,1275,1369,2644
gemini-2.0-flash-exp,Coalesce vs Repartition,case2-5.py,1253,31,1284
gemini-2.0-flash-exp,Map vs MapPartitions,case2-5.py,1242,616,1858
gemini-2.0-flash-exp,Serialized Data Formats,case2-5.py,1286,596,1882
gemini-2.0-flash-exp,Avoiding UDFs,case2-5.py,1252,8187,9439
gemini-2.0-flash-exp,All,case2-5.py,2095,1736,3831
gemini-1.0-pro-002,RDD vs DataFrame,case2-6.py,7870,628,8498
gemini-1.0-pro-002,Coalesce vs Repartition,case2-6.py,7848,281,8129
gemini-1.0-pro-002,Map vs MapPartitions,case2-6.py,7837,256,8093
gemini-1.0-pro-002,Serialized Data Formats,case2-6.py,7881,525,8406
gemini-1.0-pro-002,Avoiding UDFs,case2-6.py,7847,3495,11342
gemini-1.0-pro-002,All,case2-6.py,8690,1097,9787
gemini-1.5-flash-002,RDD vs DataFrame,case2-6.py,7870,1030,8900
gemini-1.5-flash-002,Coalesce vs Repartition,case2-6.py,7848,31,7879
gemini-1.5-flash-002,Map vs MapPartitions,case2-6.py,7837,427,8264
gemini-1.5-flash-002,Serialized Data Formats,case2-6.py,7881,530,8411
gemini-1.5-flash-002,Avoiding UDFs,case2-6.py,7847,1354,9201
gemini-1.5-flash-002,All,case2-6.py,8690,2162,10852
gemini-2.0-flash-exp,RDD vs DataFrame,case2-6.py,7870,2807,10677
gemini-2.0-flash-exp,Coalesce vs Repartition,case2-6.py,7848,31,7879
gemini-2.0-flash-exp,Map vs MapPartitions,case2-6.py,7837,450,8287
gemini-2.0-flash-exp,Serialized Data Formats,case2-6.py,7881,1924,9805
gemini-2.0-flash-exp,Avoiding UDFs,case2-6.py,7847,2599,10446
gemini-2.0-flash-exp,All,case2-6.py,8690,5654,14344
gemini-1.0-pro-002,RDD vs DataFrame,case2-7.py,940,785,1725
gemini-1.0-pro-002,Coalesce vs Repartition,case2-7.py,918,364,1282
gemini-1.0-pro-002,Map vs MapPartitions,case2-7.py,907,360,1267
gemini-1.0-pro-002,Serialized Data Formats,case2-7.py,951,299,1250
gemini-1.0-pro-002,Avoiding UDFs,case2-7.py,917,400,1317
gemini-1.0-pro-002,All,case2-7.py,1760,338,2098
gemini-1.5-flash-002,RDD vs DataFrame,case2-7.py,940,808,1748
gemini-1.5-flash-002,Coalesce vs Repartition,case2-7.py,918,31,949
gemini-1.5-flash-002,Map vs MapPartitions,case2-7.py,907,429,1336
gemini-1.5-flash-002,Serialized Data Formats,case2-7.py,951,411,1362
gemini-1.5-flash-002,Avoiding UDFs,case2-7.py,917,511,1428
gemini-1.5-flash-002,All,case2-7.py,1760,1018,2778
gemini-2.0-flash-exp,RDD vs DataFrame,case2-7.py,940,8181,9121
gemini-2.0-flash-exp,Coalesce vs Repartition,case2-7.py,918,31,949
gemini-2.0-flash-exp,Map vs MapPartitions,case2-7.py,907,496,1403
gemini-2.0-flash-exp,Serialized Data Formats,case2-7.py,951,378,1329
gemini-2.0-flash-exp,Avoiding UDFs,case2-7.py,917,795,1712
gemini-2.0-flash-exp,All,case2-7.py,1760,1310,3070
gemini-1.0-pro-002,RDD vs DataFrame,case2-8.py,3275,290,3565
gemini-1.0-pro-002,Coalesce vs Repartition,case2-8.py,3253,249,3502
gemini-1.0-pro-002,Map vs MapPartitions,case2-8.py,3242,260,3502
gemini-1.0-pro-002,Serialized Data Formats,case2-8.py,3286,567,3853
gemini-1.0-pro-002,Avoiding UDFs,case2-8.py,3252,30,3282
gemini-1.0-pro-002,All,case2-8.py,4095,238,4333
gemini-1.5-flash-002,RDD vs DataFrame,case2-8.py,3275,807,4082
gemini-1.5-flash-002,Coalesce vs Repartition,case2-8.py,3253,399,3652
gemini-1.5-flash-002,Map vs MapPartitions,case2-8.py,3242,317,3559
gemini-1.5-flash-002,Serialized Data Formats,case2-8.py,3286,486,3772
gemini-1.5-flash-002,Avoiding UDFs,case2-8.py,3252,637,3889
gemini-1.5-flash-002,All,case2-8.py,4095,1266,5361
gemini-2.0-flash-exp,RDD vs DataFrame,case2-8.py,3275,1011,4286
gemini-2.0-flash-exp,Coalesce vs Repartition,case2-8.py,3253,476,3729
gemini-2.0-flash-exp,Map vs MapPartitions,case2-8.py,3242,272,3514
gemini-2.0-flash-exp,Serialized Data Formats,case2-8.py,3286,1558,4844
gemini-2.0-flash-exp,Avoiding UDFs,case2-8.py,3252,760,4012
gemini-2.0-flash-exp,All,case2-8.py,4095,1722,5817
gemini-1.0-pro-002,RDD vs DataFrame,case2-9.py,2038,1300,3338
gemini-1.0-pro-002,Coalesce vs Repartition,case2-9.py,2016,255,2271
gemini-1.0-pro-002,Map vs MapPartitions,case2-9.py,2005,583,2588
gemini-1.0-pro-002,Serialized Data Formats,case2-9.py,2049,294,2343
gemini-1.0-pro-002,Avoiding UDFs,case2-9.py,2015,485,2500
gemini-1.0-pro-002,All,case2-9.py,2858,864,3722
gemini-1.5-flash-002,RDD vs DataFrame,case2-9.py,2038,1225,3263
gemini-1.5-flash-002,Coalesce vs Repartition,case2-9.py,2016,279,2295
gemini-1.5-flash-002,Map vs MapPartitions,case2-9.py,2005,743,2748
gemini-1.5-flash-002,Serialized Data Formats,case2-9.py,2049,408,2457
gemini-1.5-flash-002,Avoiding UDFs,case2-9.py,2015,599,2614
gemini-1.5-flash-002,All,case2-9.py,2858,1871,4729
gemini-2.0-flash-exp,RDD vs DataFrame,case2-9.py,2038,3586,5624
gemini-2.0-flash-exp,Coalesce vs Repartition,case2-9.py,2016,364,2380
gemini-2.0-flash-exp,Map vs MapPartitions,case2-9.py,2005,609,2614
gemini-2.0-flash-exp,Serialized Data Formats,case2-9.py,2049,447,2496
gemini-2.0-flash-exp,Avoiding UDFs,case2-9.py,2015,957,2972
gemini-2.0-flash-exp,All,case2-9.py,2858,3096,5954
gemini-1.0-pro-002,RDD vs DataFrame,case3-1.py,2020,229,2249
gemini-1.0-pro-002,Coalesce vs Repartition,case3-1.py,1998,262,2260
gemini-1.0-pro-002,Map vs MapPartitions,case3-1.py,1987,1288,3275
gemini-1.0-pro-002,Serialized Data Formats,case3-1.py,2031,340,2371
gemini-1.0-pro-002,Avoiding UDFs,case3-1.py,1997,1475,3472
gemini-1.0-pro-002,All,case3-1.py,2840,664,3504
gemini-1.5-flash-002,RDD vs DataFrame,case3-1.py,2020,31,2051
gemini-1.5-flash-002,Coalesce vs Repartition,case3-1.py,1998,31,2029
gemini-1.5-flash-002,Map vs MapPartitions,case3-1.py,1987,31,2018
gemini-1.5-flash-002,Serialized Data Formats,case3-1.py,2031,364,2395
gemini-1.5-flash-002,Avoiding UDFs,case3-1.py,1997,1908,3905
gemini-1.5-flash-002,All,case3-1.py,2840,1882,4722
gemini-2.0-flash-exp,RDD vs DataFrame,case3-1.py,2020,31,2051
gemini-2.0-flash-exp,Coalesce vs Repartition,case3-1.py,1998,31,2029
gemini-2.0-flash-exp,Map vs MapPartitions,case3-1.py,1987,31,2018
gemini-2.0-flash-exp,Serialized Data Formats,case3-1.py,2031,797,2828
gemini-2.0-flash-exp,Avoiding UDFs,case3-1.py,1997,1185,3182
gemini-2.0-flash-exp,All,case3-1.py,2840,683,3523
gemini-1.0-pro-002,RDD vs DataFrame,case3-10.py,1630,341,1971
gemini-1.0-pro-002,Coalesce vs Repartition,case3-10.py,1608,283,1891
gemini-1.0-pro-002,Map vs MapPartitions,case3-10.py,1597,268,1865
gemini-1.0-pro-002,Serialized Data Formats,case3-10.py,1641,396,2037
gemini-1.0-pro-002,Avoiding UDFs,case3-10.py,1607,30,1637
gemini-1.0-pro-002,All,case3-10.py,2450,118,2568
gemini-1.5-flash-002,RDD vs DataFrame,case3-10.py,1630,31,1661
gemini-1.5-flash-002,Coalesce vs Repartition,case3-10.py,1608,31,1639
gemini-1.5-flash-002,Map vs MapPartitions,case3-10.py,1597,31,1628
gemini-1.5-flash-002,Serialized Data Formats,case3-10.py,1641,452,2093
gemini-1.5-flash-002,Avoiding UDFs,case3-10.py,1607,31,1638
gemini-1.5-flash-002,All,case3-10.py,2450,316,2766
gemini-2.0-flash-exp,RDD vs DataFrame,case3-10.py,1630,31,1661
gemini-2.0-flash-exp,Coalesce vs Repartition,case3-10.py,1608,31,1639
gemini-2.0-flash-exp,Map vs MapPartitions,case3-10.py,1597,31,1628
gemini-2.0-flash-exp,Serialized Data Formats,case3-10.py,1641,873,2514
gemini-2.0-flash-exp,Avoiding UDFs,case3-10.py,1607,31,1638
gemini-2.0-flash-exp,All,case3-10.py,2450,348,2798
gemini-1.0-pro-002,RDD vs DataFrame,case3-2.py,1661,1710,3371
gemini-1.0-pro-002,Coalesce vs Repartition,case3-2.py,1639,207,1846
gemini-1.0-pro-002,Map vs MapPartitions,case3-2.py,1628,324,1952
gemini-1.0-pro-002,Serialized Data Formats,case3-2.py,1672,607,2279
gemini-1.0-pro-002,Avoiding UDFs,case3-2.py,1638,745,2383
gemini-1.0-pro-002,All,case3-2.py,2481,898,3379
gemini-1.5-flash-002,RDD vs DataFrame,case3-2.py,1661,2063,3724
gemini-1.5-flash-002,Coalesce vs Repartition,case3-2.py,1639,31,1670
gemini-1.5-flash-002,Map vs MapPartitions,case3-2.py,1628,31,1659
gemini-1.5-flash-002,Serialized Data Formats,case3-2.py,1672,521,2193
gemini-1.5-flash-002,Avoiding UDFs,case3-2.py,1638,751,2389
gemini-1.5-flash-002,All,case3-2.py,2481,891,3372
gemini-2.0-flash-exp,RDD vs DataFrame,case3-2.py,1661,279,1940
gemini-2.0-flash-exp,Coalesce vs Repartition,case3-2.py,1639,31,1670
gemini-2.0-flash-exp,Map vs MapPartitions,case3-2.py,1628,289,1917
gemini-2.0-flash-exp,Serialized Data Formats,case3-2.py,1672,578,2250
gemini-2.0-flash-exp,Avoiding UDFs,case3-2.py,1638,31,1669
gemini-2.0-flash-exp,All,case3-2.py,2481,618,3099
gemini-1.0-pro-002,RDD vs DataFrame,case3-3.py,807,197,1004
gemini-1.0-pro-002,Coalesce vs Repartition,case3-3.py,785,217,1002
gemini-1.0-pro-002,Map vs MapPartitions,case3-3.py,774,308,1082
gemini-1.0-pro-002,Serialized Data Formats,case3-3.py,818,254,1072
gemini-1.0-pro-002,Avoiding UDFs,case3-3.py,784,305,1089
gemini-1.0-pro-002,All,case3-3.py,1627,119,1746
gemini-1.5-flash-002,RDD vs DataFrame,case3-3.py,807,31,838
gemini-1.5-flash-002,Coalesce vs Repartition,case3-3.py,785,31,816
gemini-1.5-flash-002,Map vs MapPartitions,case3-3.py,774,31,805
gemini-1.5-flash-002,Serialized Data Formats,case3-3.py,818,332,1150
gemini-1.5-flash-002,Avoiding UDFs,case3-3.py,784,31,815
gemini-1.5-flash-002,All,case3-3.py,1627,308,1935
gemini-2.0-flash-exp,RDD vs DataFrame,case3-3.py,807,31,838
gemini-2.0-flash-exp,Coalesce vs Repartition,case3-3.py,785,31,816
gemini-2.0-flash-exp,Map vs MapPartitions,case3-3.py,774,31,805
gemini-2.0-flash-exp,Serialized Data Formats,case3-3.py,818,371,1189
gemini-2.0-flash-exp,Avoiding UDFs,case3-3.py,784,31,815
gemini-2.0-flash-exp,All,case3-3.py,1627,346,1973
gemini-1.0-pro-002,RDD vs DataFrame,case3-4.py,4029,157,4186
gemini-1.0-pro-002,Coalesce vs Repartition,case3-4.py,4007,246,4253
gemini-1.0-pro-002,Map vs MapPartitions,case3-4.py,3996,465,4461
gemini-1.0-pro-002,Serialized Data Formats,case3-4.py,4040,1070,5110
gemini-1.0-pro-002,Avoiding UDFs,case3-4.py,4006,436,4442
gemini-1.0-pro-002,All,case3-4.py,4849,275,5124
gemini-1.5-flash-002,RDD vs DataFrame,case3-4.py,4029,31,4060
gemini-1.5-flash-002,Coalesce vs Repartition,case3-4.py,4007,31,4038
gemini-1.5-flash-002,Map vs MapPartitions,case3-4.py,3996,31,4027
gemini-1.5-flash-002,Serialized Data Formats,case3-4.py,4040,772,4812
gemini-1.5-flash-002,Avoiding UDFs,case3-4.py,4006,520,4526
gemini-1.5-flash-002,All,case3-4.py,4849,1591,6440
gemini-2.0-flash-exp,RDD vs DataFrame,case3-4.py,4029,31,4060
gemini-2.0-flash-exp,Coalesce vs Repartition,case3-4.py,4007,31,4038
gemini-2.0-flash-exp,Map vs MapPartitions,case3-4.py,3996,31,4027
gemini-2.0-flash-exp,Serialized Data Formats,case3-4.py,4040,1227,5267
gemini-2.0-flash-exp,Avoiding UDFs,case3-4.py,4006,576,4582
gemini-2.0-flash-exp,All,case3-4.py,4849,1090,5939
gemini-1.0-pro-002,RDD vs DataFrame,case3-5.py,2831,1834,4665
gemini-1.0-pro-002,Coalesce vs Repartition,case3-5.py,2809,269,3078
gemini-1.0-pro-002,Map vs MapPartitions,case3-5.py,2798,1050,3848
gemini-1.0-pro-002,Serialized Data Formats,case3-5.py,2842,499,3341
gemini-1.0-pro-002,Avoiding UDFs,case3-5.py,2808,768,3576
gemini-1.0-pro-002,All,case3-5.py,3651,1211,4862
gemini-1.5-flash-002,RDD vs DataFrame,case3-5.py,2831,1445,4276
gemini-1.5-flash-002,Coalesce vs Repartition,case3-5.py,2809,31,2840
gemini-1.5-flash-002,Map vs MapPartitions,case3-5.py,2798,2714,5512
gemini-1.5-flash-002,Serialized Data Formats,case3-5.py,2842,486,3328
gemini-1.5-flash-002,Avoiding UDFs,case3-5.py,2808,781,3589
gemini-1.5-flash-002,All,case3-5.py,3651,3032,6683
gemini-2.0-flash-exp,RDD vs DataFrame,case3-5.py,2831,2960,5791
gemini-2.0-flash-exp,Coalesce vs Repartition,case3-5.py,2809,31,2840
gemini-2.0-flash-exp,Map vs MapPartitions,case3-5.py,2798,2001,4799
gemini-2.0-flash-exp,Serialized Data Formats,case3-5.py,2842,718,3560
gemini-2.0-flash-exp,Avoiding UDFs,case3-5.py,2808,2405,5213
gemini-2.0-flash-exp,All,case3-5.py,3651,5735,9386
gemini-1.0-pro-002,RDD vs DataFrame,case3-6.py,1779,242,2021
gemini-1.0-pro-002,Coalesce vs Repartition,case3-6.py,1757,235,1992
gemini-1.0-pro-002,Map vs MapPartitions,case3-6.py,1746,326,2072
gemini-1.0-pro-002,Serialized Data Formats,case3-6.py,1790,286,2076
gemini-1.0-pro-002,Avoiding UDFs,case3-6.py,1756,285,2041
gemini-1.0-pro-002,All,case3-6.py,2599,133,2732
gemini-1.5-flash-002,RDD vs DataFrame,case3-6.py,1779,31,1810
gemini-1.5-flash-002,Coalesce vs Repartition,case3-6.py,1757,31,1788
gemini-1.5-flash-002,Map vs MapPartitions,case3-6.py,1746,31,1777
gemini-1.5-flash-002,Serialized Data Formats,case3-6.py,1790,391,2181
gemini-1.5-flash-002,Avoiding UDFs,case3-6.py,1756,31,1787
gemini-1.5-flash-002,All,case3-6.py,2599,302,2901
gemini-2.0-flash-exp,RDD vs DataFrame,case3-6.py,1779,31,1810
gemini-2.0-flash-exp,Coalesce vs Repartition,case3-6.py,1757,31,1788
gemini-2.0-flash-exp,Map vs MapPartitions,case3-6.py,1746,31,1777
gemini-2.0-flash-exp,Serialized Data Formats,case3-6.py,1790,379,2169
gemini-2.0-flash-exp,Avoiding UDFs,case3-6.py,1756,31,1787
gemini-2.0-flash-exp,All,case3-6.py,2599,355,2954
gemini-1.0-pro-002,RDD vs DataFrame,case3-7.py,1237,270,1507
gemini-1.0-pro-002,Coalesce vs Repartition,case3-7.py,1215,30,1245
gemini-1.0-pro-002,Map vs MapPartitions,case3-7.py,1204,150,1354
gemini-1.0-pro-002,Serialized Data Formats,case3-7.py,1248,261,1509
gemini-1.0-pro-002,Avoiding UDFs,case3-7.py,1214,30,1244
gemini-1.0-pro-002,All,case3-7.py,2057,133,2190
gemini-1.5-flash-002,RDD vs DataFrame,case3-7.py,1237,31,1268
gemini-1.5-flash-002,Coalesce vs Repartition,case3-7.py,1215,31,1246
gemini-1.5-flash-002,Map vs MapPartitions,case3-7.py,1204,31,1235
gemini-1.5-flash-002,Serialized Data Formats,case3-7.py,1248,391,1639
gemini-1.5-flash-002,Avoiding UDFs,case3-7.py,1214,31,1245
gemini-1.5-flash-002,All,case3-7.py,2057,323,2380
gemini-2.0-flash-exp,RDD vs DataFrame,case3-7.py,1237,31,1268
gemini-2.0-flash-exp,Coalesce vs Repartition,case3-7.py,1215,31,1246
gemini-2.0-flash-exp,Map vs MapPartitions,case3-7.py,1204,31,1235
gemini-2.0-flash-exp,Serialized Data Formats,case3-7.py,1248,543,1791
gemini-2.0-flash-exp,Avoiding UDFs,case3-7.py,1214,31,1245
gemini-2.0-flash-exp,All,case3-7.py,2057,336,2393
gemini-1.0-pro-002,RDD vs DataFrame,case3-8.py,31393,424,31817
gemini-1.0-pro-002,Coalesce vs Repartition,case3-8.py,31371,242,31613
gemini-1.0-pro-002,Map vs MapPartitions,case3-8.py,31360,375,31735
gemini-1.0-pro-002,Serialized Data Formats,case3-8.py,31404,464,31868
gemini-1.0-pro-002,Avoiding UDFs,case3-8.py,31370,339,31709
gemini-1.0-pro-002,All,case3-8.py,32213,248,32461
gemini-1.5-flash-002,RDD vs DataFrame,case3-8.py,31393,980,32373
gemini-1.5-flash-002,Coalesce vs Repartition,case3-8.py,31371,1329,32700
gemini-1.5-flash-002,Map vs MapPartitions,case3-8.py,31360,403,31763
gemini-1.5-flash-002,Serialized Data Formats,case3-8.py,31404,363,31767
gemini-1.5-flash-002,Avoiding UDFs,case3-8.py,31370,417,31787
gemini-1.5-flash-002,All,case3-8.py,32213,1292,33505
gemini-2.0-flash-exp,RDD vs DataFrame,case3-8.py,31393,2210,33603
gemini-2.0-flash-exp,Coalesce vs Repartition,case3-8.py,31371,31,31402
gemini-2.0-flash-exp,Map vs MapPartitions,case3-8.py,31360,322,31682
gemini-2.0-flash-exp,Serialized Data Formats,case3-8.py,31404,373,31777
gemini-2.0-flash-exp,Avoiding UDFs,case3-8.py,31370,31,31401
gemini-2.0-flash-exp,All,case3-8.py,32213,1992,34205
gemini-1.0-pro-002,RDD vs DataFrame,case3-9.py,2418,200,2618
gemini-1.0-pro-002,Coalesce vs Repartition,case3-9.py,2396,217,2613
gemini-1.0-pro-002,Map vs MapPartitions,case3-9.py,2385,616,3001
gemini-1.0-pro-002,Serialized Data Formats,case3-9.py,2429,200,2629
gemini-1.0-pro-002,Avoiding UDFs,case3-9.py,2395,601,2996
gemini-1.0-pro-002,All,case3-9.py,3238,133,3371
gemini-1.5-flash-002,RDD vs DataFrame,case3-9.py,2418,31,2449
gemini-1.5-flash-002,Coalesce vs Repartition,case3-9.py,2396,31,2427
gemini-1.5-flash-002,Map vs MapPartitions,case3-9.py,2385,379,2764
gemini-1.5-flash-002,Serialized Data Formats,case3-9.py,2429,285,2714
gemini-1.5-flash-002,Avoiding UDFs,case3-9.py,2395,489,2884
gemini-1.5-flash-002,All,case3-9.py,3238,801,4039
gemini-2.0-flash-exp,RDD vs DataFrame,case3-9.py,2418,31,2449
gemini-2.0-flash-exp,Coalesce vs Repartition,case3-9.py,2396,31,2427
gemini-2.0-flash-exp,Map vs MapPartitions,case3-9.py,2385,878,3263
gemini-2.0-flash-exp,Serialized Data Formats,case3-9.py,2429,502,2931
gemini-2.0-flash-exp,Avoiding UDFs,case3-9.py,2395,1124,3519
gemini-2.0-flash-exp,All,case3-9.py,3238,921,4159
gemini-1.0-pro-002,RDD vs DataFrame,case4-1.py,1055,319,1374
gemini-1.0-pro-002,Coalesce vs Repartition,case4-1.py,1033,178,1211
gemini-1.0-pro-002,Map vs MapPartitions,case4-1.py,1022,433,1455
gemini-1.0-pro-002,Serialized Data Formats,case4-1.py,1066,289,1355
gemini-1.0-pro-002,Avoiding UDFs,case4-1.py,1032,384,1416
gemini-1.0-pro-002,All,case4-1.py,1875,420,2295
gemini-1.5-flash-002,RDD vs DataFrame,case4-1.py,1055,31,1086
gemini-1.5-flash-002,Coalesce vs Repartition,case4-1.py,1033,31,1064
gemini-1.5-flash-002,Map vs MapPartitions,case4-1.py,1022,31,1053
gemini-1.5-flash-002,Serialized Data Formats,case4-1.py,1066,524,1590
gemini-1.5-flash-002,Avoiding UDFs,case4-1.py,1032,457,1489
gemini-1.5-flash-002,All,case4-1.py,1875,1060,2935
gemini-2.0-flash-exp,RDD vs DataFrame,case4-1.py,1055,31,1086
gemini-2.0-flash-exp,Coalesce vs Repartition,case4-1.py,1033,31,1064
gemini-2.0-flash-exp,Map vs MapPartitions,case4-1.py,1022,31,1053
gemini-2.0-flash-exp,Serialized Data Formats,case4-1.py,1066,957,2023
gemini-2.0-flash-exp,Avoiding UDFs,case4-1.py,1032,758,1790
gemini-2.0-flash-exp,All,case4-1.py,1875,795,2670
gemini-1.0-pro-002,RDD vs DataFrame,case4-10.py,1087,259,1346
gemini-1.0-pro-002,Coalesce vs Repartition,case4-10.py,1065,243,1308
gemini-1.0-pro-002,Map vs MapPartitions,case4-10.py,1054,638,1692
gemini-1.0-pro-002,Serialized Data Formats,case4-10.py,1098,300,1398
gemini-1.0-pro-002,Avoiding UDFs,case4-10.py,1064,584,1648
gemini-1.0-pro-002,All,case4-10.py,1907,466,2373
gemini-1.5-flash-002,RDD vs DataFrame,case4-10.py,1087,31,1118
gemini-1.5-flash-002,Coalesce vs Repartition,case4-10.py,1065,31,1096
gemini-1.5-flash-002,Map vs MapPartitions,case4-10.py,1054,31,1085
gemini-1.5-flash-002,Serialized Data Formats,case4-10.py,1098,593,1691
gemini-1.5-flash-002,Avoiding UDFs,case4-10.py,1064,678,1742
gemini-1.5-flash-002,All,case4-10.py,1907,851,2758
gemini-2.0-flash-exp,RDD vs DataFrame,case4-10.py,1087,31,1118
gemini-2.0-flash-exp,Coalesce vs Repartition,case4-10.py,1065,31,1096
gemini-2.0-flash-exp,Map vs MapPartitions,case4-10.py,1054,31,1085
gemini-2.0-flash-exp,Serialized Data Formats,case4-10.py,1098,31,1129
gemini-2.0-flash-exp,Avoiding UDFs,case4-10.py,1064,951,2015
gemini-2.0-flash-exp,All,case4-10.py,1907,980,2887
gemini-1.0-pro-002,RDD vs DataFrame,case4-2.py,802,232,1034
gemini-1.0-pro-002,Coalesce vs Repartition,case4-2.py,780,217,997
gemini-1.0-pro-002,Map vs MapPartitions,case4-2.py,769,222,991
gemini-1.0-pro-002,Serialized Data Formats,case4-2.py,813,277,1090
gemini-1.0-pro-002,Avoiding UDFs,case4-2.py,779,314,1093
gemini-1.0-pro-002,All,case4-2.py,1622,349,1971
gemini-1.5-flash-002,RDD vs DataFrame,case4-2.py,802,31,833
gemini-1.5-flash-002,Coalesce vs Repartition,case4-2.py,780,31,811
gemini-1.5-flash-002,Map vs MapPartitions,case4-2.py,769,31,800
gemini-1.5-flash-002,Serialized Data Formats,case4-2.py,813,31,844
gemini-1.5-flash-002,Avoiding UDFs,case4-2.py,779,458,1237
gemini-1.5-flash-002,All,case4-2.py,1622,628,2250
gemini-2.0-flash-exp,RDD vs DataFrame,case4-2.py,802,31,833
gemini-2.0-flash-exp,Coalesce vs Repartition,case4-2.py,780,31,811
gemini-2.0-flash-exp,Map vs MapPartitions,case4-2.py,769,31,800
gemini-2.0-flash-exp,Serialized Data Formats,case4-2.py,813,645,1458
gemini-2.0-flash-exp,Avoiding UDFs,case4-2.py,779,572,1351
gemini-2.0-flash-exp,All,case4-2.py,1622,542,2164
gemini-1.0-pro-002,RDD vs DataFrame,case4-3.py,794,30,824
gemini-1.0-pro-002,Coalesce vs Repartition,case4-3.py,772,160,932
gemini-1.0-pro-002,Map vs MapPartitions,case4-3.py,761,272,1033
gemini-1.0-pro-002,Serialized Data Formats,case4-3.py,805,259,1064
gemini-1.0-pro-002,Avoiding UDFs,case4-3.py,771,759,1530
gemini-1.0-pro-002,All,case4-3.py,1614,488,2102
gemini-1.5-flash-002,RDD vs DataFrame,case4-3.py,794,31,825
gemini-1.5-flash-002,Coalesce vs Repartition,case4-3.py,772,31,803
gemini-1.5-flash-002,Map vs MapPartitions,case4-3.py,761,31,792
gemini-1.5-flash-002,Serialized Data Formats,case4-3.py,805,31,836
gemini-1.5-flash-002,Avoiding UDFs,case4-3.py,771,322,1093
gemini-1.5-flash-002,All,case4-3.py,1614,638,2252
gemini-2.0-flash-exp,RDD vs DataFrame,case4-3.py,794,31,825
gemini-2.0-flash-exp,Coalesce vs Repartition,case4-3.py,772,31,803
gemini-2.0-flash-exp,Map vs MapPartitions,case4-3.py,761,31,792
gemini-2.0-flash-exp,Serialized Data Formats,case4-3.py,805,371,1176
gemini-2.0-flash-exp,Avoiding UDFs,case4-3.py,771,962,1733
gemini-2.0-flash-exp,All,case4-3.py,1614,731,2345
gemini-1.0-pro-002,RDD vs DataFrame,case4-4.py,896,320,1216
gemini-1.0-pro-002,Coalesce vs Repartition,case4-4.py,874,160,1034
gemini-1.0-pro-002,Map vs MapPartitions,case4-4.py,863,394,1257
gemini-1.0-pro-002,Serialized Data Formats,case4-4.py,907,113,1020
gemini-1.0-pro-002,Avoiding UDFs,case4-4.py,873,472,1345
gemini-1.0-pro-002,All,case4-4.py,1716,351,2067
gemini-1.5-flash-002,RDD vs DataFrame,case4-4.py,896,31,927
gemini-1.5-flash-002,Coalesce vs Repartition,case4-4.py,874,31,905
gemini-1.5-flash-002,Map vs MapPartitions,case4-4.py,863,31,894
gemini-1.5-flash-002,Serialized Data Formats,case4-4.py,907,31,938
gemini-1.5-flash-002,Avoiding UDFs,case4-4.py,873,637,1510
gemini-1.5-flash-002,All,case4-4.py,1716,831,2547
gemini-2.0-flash-exp,RDD vs DataFrame,case4-4.py,896,31,927
gemini-2.0-flash-exp,Coalesce vs Repartition,case4-4.py,874,31,905
gemini-2.0-flash-exp,Map vs MapPartitions,case4-4.py,863,31,894
gemini-2.0-flash-exp,Serialized Data Formats,case4-4.py,907,650,1557
gemini-2.0-flash-exp,Avoiding UDFs,case4-4.py,873,856,1729
gemini-2.0-flash-exp,All,case4-4.py,1716,645,2361
gemini-1.0-pro-002,RDD vs DataFrame,case4-5.py,3558,235,3793
gemini-1.0-pro-002,Coalesce vs Repartition,case4-5.py,3536,220,3756
gemini-1.0-pro-002,Map vs MapPartitions,case4-5.py,3525,431,3956
gemini-1.0-pro-002,Serialized Data Formats,case4-5.py,3569,3613,7182
gemini-1.0-pro-002,Avoiding UDFs,case4-5.py,3535,980,4515
gemini-1.0-pro-002,All,case4-5.py,4378,781,5159
gemini-1.5-flash-002,RDD vs DataFrame,case4-5.py,3558,594,4152
gemini-1.5-flash-002,Coalesce vs Repartition,case4-5.py,3536,31,3567
gemini-1.5-flash-002,Map vs MapPartitions,case4-5.py,3525,31,3556
gemini-1.5-flash-002,Serialized Data Formats,case4-5.py,3569,584,4153
gemini-1.5-flash-002,Avoiding UDFs,case4-5.py,3535,501,4036
gemini-1.5-flash-002,All,case4-5.py,4378,1046,5424
gemini-2.0-flash-exp,RDD vs DataFrame,case4-5.py,3558,330,3888
gemini-2.0-flash-exp,Coalesce vs Repartition,case4-5.py,3536,31,3567
gemini-2.0-flash-exp,Map vs MapPartitions,case4-5.py,3525,740,4265
gemini-2.0-flash-exp,Serialized Data Formats,case4-5.py,3569,1899,5468
gemini-2.0-flash-exp,Avoiding UDFs,case4-5.py,3535,2124,5659
gemini-2.0-flash-exp,All,case4-5.py,4378,3499,7877
gemini-1.0-pro-002,RDD vs DataFrame,case4-6.py,772,163,935
gemini-1.0-pro-002,Coalesce vs Repartition,case4-6.py,750,298,1048
gemini-1.0-pro-002,Map vs MapPartitions,case4-6.py,739,154,893
gemini-1.0-pro-002,Serialized Data Formats,case4-6.py,783,239,1022
gemini-1.0-pro-002,Avoiding UDFs,case4-6.py,749,862,1611
gemini-1.0-pro-002,All,case4-6.py,1592,818,2410
gemini-1.5-flash-002,RDD vs DataFrame,case4-6.py,772,31,803
gemini-1.5-flash-002,Coalesce vs Repartition,case4-6.py,750,31,781
gemini-1.5-flash-002,Map vs MapPartitions,case4-6.py,739,31,770
gemini-1.5-flash-002,Serialized Data Formats,case4-6.py,783,31,814
gemini-1.5-flash-002,Avoiding UDFs,case4-6.py,749,899,1648
gemini-1.5-flash-002,All,case4-6.py,1592,1074,2666
gemini-2.0-flash-exp,RDD vs DataFrame,case4-6.py,772,31,803
gemini-2.0-flash-exp,Coalesce vs Repartition,case4-6.py,750,31,781
gemini-2.0-flash-exp,Map vs MapPartitions,case4-6.py,739,31,770
gemini-2.0-flash-exp,Serialized Data Formats,case4-6.py,783,31,814
gemini-2.0-flash-exp,Avoiding UDFs,case4-6.py,749,1514,2263
gemini-2.0-flash-exp,All,case4-6.py,1592,1394,2986
gemini-1.0-pro-002,RDD vs DataFrame,case4-7.py,4233,346,4579
gemini-1.0-pro-002,Coalesce vs Repartition,case4-7.py,4211,225,4436
gemini-1.0-pro-002,Map vs MapPartitions,case4-7.py,4200,312,4512
gemini-1.0-pro-002,Serialized Data Formats,case4-7.py,4244,490,4734
gemini-1.0-pro-002,Avoiding UDFs,case4-7.py,4210,1373,5583
gemini-1.0-pro-002,All,case4-7.py,5053,458,5511
gemini-1.5-flash-002,RDD vs DataFrame,case4-7.py,4233,31,4264
gemini-1.5-flash-002,Coalesce vs Repartition,case4-7.py,4211,312,4523
gemini-1.5-flash-002,Map vs MapPartitions,case4-7.py,4200,31,4231
gemini-1.5-flash-002,Serialized Data Formats,case4-7.py,4244,721,4965
gemini-1.5-flash-002,Avoiding UDFs,case4-7.py,4210,1460,5670
gemini-1.5-flash-002,All,case4-7.py,5053,1794,6847
gemini-2.0-flash-exp,RDD vs DataFrame,case4-7.py,4233,31,4264
gemini-2.0-flash-exp,Coalesce vs Repartition,case4-7.py,4211,288,4499
gemini-2.0-flash-exp,Map vs MapPartitions,case4-7.py,4200,2608,6808
gemini-2.0-flash-exp,Serialized Data Formats,case4-7.py,4244,398,4642
gemini-2.0-flash-exp,Avoiding UDFs,case4-7.py,4210,2081,6291
gemini-2.0-flash-exp,All,case4-7.py,5053,2475,7528
gemini-1.0-pro-002,RDD vs DataFrame,case4-8.py,865,30,895
gemini-1.0-pro-002,Coalesce vs Repartition,case4-8.py,843,167,1010
gemini-1.0-pro-002,Map vs MapPartitions,case4-8.py,832,591,1423
gemini-1.0-pro-002,Serialized Data Formats,case4-8.py,876,162,1038
gemini-1.0-pro-002,Avoiding UDFs,case4-8.py,842,832,1674
gemini-1.0-pro-002,All,case4-8.py,1685,606,2291
gemini-1.5-flash-002,RDD vs DataFrame,case4-8.py,865,31,896
gemini-1.5-flash-002,Coalesce vs Repartition,case4-8.py,843,31,874
gemini-1.5-flash-002,Map vs MapPartitions,case4-8.py,832,414,1246
gemini-1.5-flash-002,Serialized Data Formats,case4-8.py,876,31,907
gemini-1.5-flash-002,Avoiding UDFs,case4-8.py,842,854,1696
gemini-1.5-flash-002,All,case4-8.py,1685,857,2542
gemini-2.0-flash-exp,RDD vs DataFrame,case4-8.py,865,31,896
gemini-2.0-flash-exp,Coalesce vs Repartition,case4-8.py,843,31,874
gemini-2.0-flash-exp,Map vs MapPartitions,case4-8.py,832,31,863
gemini-2.0-flash-exp,Serialized Data Formats,case4-8.py,876,31,907
gemini-2.0-flash-exp,Avoiding UDFs,case4-8.py,842,1148,1990
gemini-2.0-flash-exp,All,case4-8.py,1685,894,2579
gemini-1.0-pro-002,RDD vs DataFrame,case4-9.py,939,378,1317
gemini-1.0-pro-002,Coalesce vs Repartition,case4-9.py,917,318,1235
gemini-1.0-pro-002,Map vs MapPartitions,case4-9.py,906,399,1305
gemini-1.0-pro-002,Serialized Data Formats,case4-9.py,950,307,1257
gemini-1.0-pro-002,Avoiding UDFs,case4-9.py,916,329,1245
gemini-1.0-pro-002,All,case4-9.py,1759,467,2226
gemini-1.5-flash-002,RDD vs DataFrame,case4-9.py,939,31,970
gemini-1.5-flash-002,Coalesce vs Repartition,case4-9.py,917,31,948
gemini-1.5-flash-002,Map vs MapPartitions,case4-9.py,906,31,937
gemini-1.5-flash-002,Serialized Data Formats,case4-9.py,950,31,981
gemini-1.5-flash-002,Avoiding UDFs,case4-9.py,916,399,1315
gemini-1.5-flash-002,All,case4-9.py,1759,463,2222
gemini-2.0-flash-exp,RDD vs DataFrame,case4-9.py,939,31,970
gemini-2.0-flash-exp,Coalesce vs Repartition,case4-9.py,917,31,948
gemini-2.0-flash-exp,Map vs MapPartitions,case4-9.py,906,31,937
gemini-2.0-flash-exp,Serialized Data Formats,case4-9.py,950,31,981
gemini-2.0-flash-exp,Avoiding UDFs,case4-9.py,916,424,1340
gemini-2.0-flash-exp,All,case4-9.py,1759,457,2216
